"Authors..Primary"	"Title.Primary"	"Pub.Year"
"Arillo,A.;Subias,L. S."	"Redescription of the longest-legged oribatid mite, Metabelbella phalangioides (Michael, 1890) com. nov., a species from Algeria and Southern Spain (Acariformes: Oribatida: Damaeidae)"	2006
"Assing,Volker"	"Four new species and additional records of Palaearctic Sunius, with two new synonymies (Coleoptera: Staphylinidae: Paederinae)"	2008
"Beck,H."	"Two new Noctuidae from Spain, one of these - Mythimna (Foehstia) valeriae Beck, sp n. - is new to Science. Eremodrina gilva (Donzel, 1837) is definitely recorded from Spain (Lepidoptera : Noctuidae)"	2007
"Calle,J. A.;Ortiz,A. S.;Rubio,R. M.;Garre,M.;Ochotorena,F."	"The Noctuidae (Lepidoptera) of Sierra Espuna Regional Park (southern Iberian Peninsula)"	2007
"Cleve,Casey;Perrine,John;Holzman,Barbara;Hines,Ellen"	"Addressing biased occurrence data in predicting potential Sierra Nevada red fox habitat for survey prioritization"	2011
"Ebmer,A. W."	"The west Palaearctic species of the genus Dufourea LEPELETIER 1841 (Insecta : Hymenoptera : Apoidea : Halictidae : Rophitinae) fifth supplement"	2008
"El Mouden,E. H.;Slimani,T.;Donaire,D.;Fernandez-Beaskoetxea,S.;Fisher,M. C.;Bosch,J."	"First Record of the Chytrid Fungus Batrachochytrium dendrobatidis in North Africa"	2011
"Fanes Trevino,Ingrid;Comas Gonzalez,Augusto;Sanchez Castillo,Pedro M."	"Catalogue of coccal green algae from continental waters of Andalusia"	2009
"Fernandez Calzado,Ma Rosa;Molero Mesa,Joaquin"	"The cartography of vegetation in the cryoromediterranean belt of Sierra Nevada: a tool for biodiversity conservation"	2011
"Fernandez Calzado,Maria Rosa;Molero Mesa,Joaquin"	"Changes in the summit flora of a Mediterranean mountain (Sierra Nevada, Spain) as a possible effect of climate change"	2013
"Fernandez Calzado,Maria Rosa;Molero Mesa,Joaquin"	"High altitude flora of Sierra Nevada (Spain)"	2011
"Foerschler,Marc I.;Klaeger,Juergen"	"Range expansion of citril finches (Carduelis citrinella) in southern Spain"	2007
"Fuentes Carretero,Julian Manuel;Ruiz Girela,Mario"	"On the presence of Sorbus intermedia (Ehrh.) Pers. in Sierra Nevada (Granada. Spain)"	2013
"Gaston,J.;Morente-Benitez,F. J."	"First record of Bradyrrhoa adrianae Asselbergs, 2002 from outside Sierra Nevada (Granada, Spain), (Lepidoptera: Pyralidae, Phycitinae)"	2014
"Gavilan,Rosario G.;Jimenez-Alfaro,Borja;Bacchetta,Gianluigi;Dimopoulos,Panayotis;Mucina,Ladislav"	"Mountain Biodiversity patterns in Southern Europe and North Africa"	2013
"Jose Guerrero,Juan;Ortiz,Antonio S.;Maria Rubio,Rosa"	"On the distribution of Idaea gelbrechti Hausmann, 2003 in the Ibero-Maghrebian region (Geometridae: Sterrhinae)"	2012
"Linares Cuesta,Jose Eduardo;Sanchez Castillo,Pedro M."	"New reports of diatoms from the Iberian Peninsula in high mountain lakes from Sierra Nevada National Park (Granada, Spain)"	2007
"Luceno,Modesto;Jimenez Mejias,Pedro;Escudero,Marcia;Sanchez Gullon,Enrique;Weickert,Pedro"	"New chorological records of two rare Cyperaceae from Andalusia"	2007
"Monserrat,V. J.;Trivino,V.;Acevedo,F.;Garcia,A."	"New data on some brown lacewings species from the Iberian Peninsula and the Canary Islands, including a new Neotropical invasive species in Portugal"	2013
"Paegelow,M.;Camacho,Olmedo M. T.;Ferraty,F.;Ferre,L.;Sarda,P.;Villa,N."	"Prospective modelling of environmental dynamics: A methodological comparison applied to mountain land cover changes"	2008
"Perez Latorre,A. V.;Pavon Nunez,M.;Hidalgo Triana,N."	"Alnus glutinosa forests in Sierra Nevada (Granada-Almeria, Spain)"	2011
"Sanchez-Gonzalez,Arturo;Lopez-Mata,Lauro;Vibrans,Heike"	"Composition and geographic distribution patterns of the fir forest flora of Cerro Tlaloc, Mexico"	2006
"Zuazo,V. H. Duran;Martinez,J. R. Francia;Pleguezuelo,C. R. Rodriguez;Raya,A. Martinez;Rodriguez,B. Carceles"	"Soil-erosion and runoff prevention by plant covers in a mountainous area (se spain): Implications for sustainable agriculture"	2006
"Aguilar Ruiz,J.;Fernandez Garcia,J.;Rodriguez Rebollo,T.;Sierra Ruiz De La Fuente,C."	"Classification Problems of some Soils in the Sierra Nevada Spain"	1986
"Alba Tercedor,J."	"Characteristics of Phenology and Distribution of the Plecopteran Species from Sierra Nevada Spain Insecta Plecoptera"	1989
"Alba-Tercedor J;Sanchez-Ortega a"	"Presence of the Genus Torleya Insecta Ephemeroptera Ephemerellidae on the Iberian Peninsula"	1982
"Arroyo Nombela,J. J.;Rodriguez Murcia,C.;Abaigar,T.;Vericad,J. R."	"Cytogenetic Analysis Gtg Cbg and nor Bands of a Wild Boar Population Sus-Scrofa-Scrofa with Chromosomal Polymorphism in the South-East of Spain"	1990
"Asselbergs,J. E. F."	"Bradyrrhoa adrianae Asselbergs, sp. n., from Spain. Epischidia (Epischidia) fulvostrigella (Eversmann, 1844) and Ancylosis (Ancylosis) maculifera Staudinger, 1870 new to the Spanish fauna (Lepidoptera: Pyralidae, Phycitinae)."	2002
"Avila,J. M."	"Comparative Analysis of Coprophagous Scarabaeoidea Coleoptera in the Faecal Pellets of Rabbit Oryctolagus-Cuniculus and in the Excrements of Other Mammals Preliminary Report"	1991
"Avila,J. M.;Pascual,F."	"Space-Temporal Distribution Models of Dung Scarabs of Sierra Nevada Granada Spain Coleoptera Scarabaeoidea"	1990
"Avila,J. M.;Pascual,F."	"Contribution to the Knowledge of Coprophagous Scarabs Coleoptera Scarabaeoidea of the Sierra Nevada Spain Iii. Altitudinal and Temporal Distribution"	1988
"Avila,J. M.;Pascual,F."	"Contribution to the Study of the Coprophagous Scarabaeoidea from the Sierra Nevada Spain I. Introduction and Species List Coleoptera Scarabaeoidea"	1987
"Avila,J. M.;Pascual,Y. F."	"Contribution to the Study of the Coprophagous Scarabaeidae from the Sierra Nevada Spain V. Autoecology of Species of the Families Scarabaeidae and Geotrupidae Coleoptera Scarabaeoidea"	1988
"Avila,Jose M.;Romero-Alcaraz,Eduardo"	"[Aphodius (Loraspis) frater Mulsant and Rey, 1870 present in the south of Spain (Coleoptera, Scarabaeoidea, Aphodiidae)]"	2000
"Barahona Fernandez,E.;Linares,J."	"The Soils of the Barranco-Hondo Sierra-Nevada Spain 1. Typology and Soil Forming Factors"	1979
"Bastazo,G.;Vela,J. M.;Avila,J. M."	"Chrysomelidae Coleoptera of Sierra Nevada Southern Spain"	1989
"Baudiere,A.;Serve,L."	"Oro Mediterranean Groupings in the Eastern Pyrenees and their Relation to Similar Groups in the Sierra-Nevada"	1975
"Beaucournu J-C"	"A New Flea for the Iberian Fauna Peromyscopsylla-Spectabilis-Viatrix New-Subspecies Siphonaptera Leptopsyllidae"	1975
"Bermejo-Orantes,F. J.;Garcia-Fernandez,P."	"Morphological variability of Apis mellifera iberica in different apiaries of southern Spain"	1995
"Blanca,G.;Clemente Munoz,M.;Hernandez Bermejo,J. E.;Matilla,A.;Molero Mesa,J.;Pujadas,A."	"Restoration Project for the Jardin De Altura De Sierra Nevada Sierra Nevada High Altitude Garden Granada Spain"	1990
"Blanca,G.;Molero Mesa,J."	"Threat of Extinction in Sierra Nevada Granada Spain"	1990
"Bocio,I.;Lorite,J.;Navarro,F. B.;Valle,F."	"[Application of phytosociology in the restoration of fire-affected zones. An example in Sierra Nevada (southeast Spain).]"	2000
"Boettinger,Janis L.;Schupp,Eugene W.;Castro,Jorge;Gomez,Jose Maria;Zamora,Regino"	"Soil acidification following burning of pine plantations, Sierra Nevada, Spain"	2001
"Boucher,C."	"Data for a Phytoecological Map of Andalusia Spain I. Abiotic Environment"	1989
"Brugues,Montserrat;Sergio,Cecilia;Casas,Creu;Cros,Rosa M."	"Rediscovery of Brachymenium commutatum (Mull.Hal.) A. Jaeger and Pohlia andalusica (Hohn.) Broth. in the Sierra Nevada (SE Spain)."	2003
"Brullo,S.;Pavone,P.;Salmeri,C."	"A new species of Allium sect. Codonoprasum from Sierra Nevada (Spain)"	1996
"Calle Martinez,D.;Vilchez Quero,A.;Casas Jimenez,J. J."	"Chironomids (Diptera) of the Upper Guadalquivir (Sierra de Cazorla, Southern Spain)"	1995
"Casas,J. Jesus;Langton,Peter H."	"The larva and pupa of Diamesa veletensis Serra-Tosio, 1971 (Diptera: Chironomidae)"	2001
"Cebolla Lozano,C.;Rivas Ponce,M. A."	"Considerations on Festuca-Baetica in Sierra Nevada Granada Spain"	1990
"Chueca,F. E."	"Plant Species and Communities of the Calcareous Region of the Sierra-Nevada Plants from Dornajo and Treveneque"	1973
"Dathe,Holger H."	"Studies on the systematics and taxonomy of the genus Hylaeus F. (3) (Apidae, Colletinae). A revision of the Hylaeus nivalis group in Europe, and the identity of additional Western Palaeartic species"	2000
"de Figueroa,Jose Manuel Tierno;Sanchez-Ortega,Antonino"	"Imaginal feeding of twelve Nemouroidean stonefly species (Insecta, Plecoptera)"	2000
"De Figueroa,Jose Manuel Tierno;Sanchez-Ortega,Antonino"	"Imaginal feeding of certain Systellognathan stonefly species (Insecta: Plecoptera)"	1999
"De Worms,C. G. M."	"Plebicula-Golgus and Other Butterflies in the Sierra-Nevada Spain July 1975"	1976
"Dominguez Lozano,F.;Galicia Herbada,D.;Moreno Rivero,L.;Moreno Saiz,J. C.;Sainz Ollero,H."	"Areas of high floristic endemism in Iberia and the Balearic islands: An approach to biodiversity conservation using narrow endemics"	2000
"Dominguez Lozano,F.;Galicia Herbada,D.;Moreno Rivero,L.;Moreno Saiz,J. C.;Sainz Ollero,H."	"Threatened plants in peninsular and Balearic Spain: A report based on the EU Habitats Directive"	1996
"Dufour,C."	"The Identity of Tipula-Saginata Bergroth and Tipula-Obscuriventris Strobl and the Description of Tipula-Leo New-Species Sp. from the Sierra Nevada in Spain Diptera Tipulidae"	1991
"Dufour,C."	"Tipula-Nevada New-Species and Tipula-Invenusta-Microinvenusta New-Subspecies from the Heights of Sierra Nevada in Spain Diptera Tipulidae"	1990
"Dufour,C.;Oosterbroek,P."	"Tipula-Vaillanti-Andalucia New-Subspecies from Southern Spain Diptera Tipulidae"	1990
"Durrieu,Guy;Adhikari,Mahesh K."	"Distribution of some groups of plant parasitic fungi in high mountains"	1993
"Egea,J. M.;Llimona,X.;Casares,M."	"Silicicolous Lichen Flora of the Highest Part of the Sierra-Nevada Spain"	1982
"Evers,A. M. J."	"Synopsis of the Monophylum of Attalus-Tristis Luc. with a Description of a New Species Attalus-Santiagoi New-Species in the Southwestern Palearctic 71st Contribution to the Knowledge of the Malachiidae"	1988
"Fernandez-Escudero,Ignacio;Tinaut,Alberto"	"Foraging strategies and dietary preferences of a high mountain ant. (Hymenoptera: Formicidae)"	1998
"Fernandez-Rubio F;Gomez-Bustillo M R"	"Rhopalocera and Zygaena-Spp of the Sierra-Nevada Spain"	1972
"Fery,H."	"Revision of a part of the memnonius-group of Hydroporus CLAIRVILLE, 1806 (Insecta: Coleoptera: Dytiscidae) with the description of nine new taxa, and notes on other species of the genus"	1999
"Fuertes,Esther;Acon,Margarita"	"Revision and chorology of genus Mnium Hedw. (Mniaceae, Musci) from the Iberian Peninsula"	1999
"Fuertes,Esther;Acon,Margarita;Olivan,Gisela"	"Sanionia (Bryopsida, amblystegiaceae) in the Iberian Peninsula. Revision and biogeograpby"	2004
"Gamisans,J.;Romero,A. T.;Morales,C."	"The Corsican Nevadan Spain France Phleum 2 Little Known Taxa"	1983
"Garrido-Garcia,J. A."	"New altitude record for Chiroptera in Europe"	1999
"Gaston,Fco Javier;Redondo,Victor M."	"Idaea davidi sp n. from Sierra Nevada (Andalusia, Spain) (Lepidoptera: Geometridae, Sterrhinae)"	2005
"Gervais,C."	"Hybridization Tests in Perennial Spanish Oats Genus Helictotrichon from the Helictotrichon-Filifolium Helictotrichon-Sarracenorum Complex"	1977
"Gil,J. A.;Varo,J."	"Bryo Sociologic Study of Rheophilic Communities of the Sierra-Nevada Spain"	1981
"Gomez,Lorena;Zamora,Regino;Maraa Gomez,Jose"	"Limitations to the regeneration of Acer granatense in the Mediterranean mountains: A multi-scale approach."	2002
"Gonzalez,M. A.;Botosaneanu,L."	"Study of 3 Hydropsyche-Spp from Spain Described by F. Schmid Insecta Trichoptera"	1985
"Gonzalez-Megias,Adela;Sanchez-Pinero,Francisco;Gomez,Jose M."	"Spatial autocorrelation affects regional population dynamic of the beetle Timarcha lugens"	2001
"G-Toth,L.;Carrillo,P.;Cruz-Pizarro,L."	"Respiratory electron transport system (ETS)-activity of the plankton and biofilm in the high-mountain lake La Caldera (Sierra Nevada, Spain)"	1995
"Guisasola,I."	"Mayflies and Stoneflies from the Rio Monachil Sierra Nevada Spain Ephemeroptera and Plecoptera"	1991
"Gutierrez Larena,B.;Fuertes Aguilar,J.;Nieto Feliner,G."	"Glacial-induced altitudinal migrations in Armeria (Plumbaginaceae) inferred from patterns of chloroplast DNA haplotype sharing"	2002
"Haeder,Donat-P;Lebert,Michael;Marangoni,Roberto;Colombetti,Giuliano"	"ELDONET: European Light Dosimeter Network hardware and software"	1999
"Haenni J-P"	"Note on the Presence of Chorisops-Tunisiae New-Record Beck. Diptera Stratiomyidae in Europe"	1990
"Henry,Jean-Paul;Magniez,Guy"	"Stygobitic Isopoda Aselloidea from Spain, III - The genus Proasellus: B - Anophtalmous species."	2003
"Hinz,W.;Kuiper,J. G. J.;Biedermann,W."	"On the Fauna of Pisidium-Spp and Other Freshwater Molluscs in the Province of Granada South Spain"	1988
"Huertas,F.;Linares,J."	"The Soils of the Barranco-Hondo Spain 2. Geochemical Study"	1979
"Jimenez Guirado,D."	"Soil Nematodes in the Sierra-Nevada of Granada Spain and Adjacent Valleys 1. Antecedents and Catalog of Genera and Species Previously Cited"	1976
"Jimenez Guirado,D."	"Soil Nematodes in the Sierra-Nevada of Granada Spain and Adjacent Valleys 2. Results of a Preliminary Sampling"	1976
"Jimenez-Guirado D"	"Species of Dorylaimus Dujardin 1845 Nematoda from Southern Spain"	1988
"Jutzeler,David;De Bros,Emmanuel"	"Observations in nature and breeding of Pseudochazara hippolyte williamsi (Romei, 1927) and Erebia hispania hispania (Butler, 1868) from Sierra Nevada (Andalusia, southern Spain) (Lepidoptera: Nymphalidae, Satyrinae)"	1995
"Kallies,Axel"	"Revision of the south-western Palaearctic species of Synansphecia (Sesiidae)"	1999
"Lacourt,J."	"Notes on the Atra Group of the Genus Tenthredo Hymenoptera Tenthridinidae with a Description of 2 New Taxa"	1980
"Laville,H."	"The Chironomids Diptera of several High Altitude Lagunas of the Sierra-Nevada Granada Spain"	1986
"Leraut,P."	"Study of Scopariineae Lepidoptera Pyralidae 2 New Taxa from the Mediterranean Region"	1981
"Loeffler,H."	"Harpacticoids Crustacea Copepoda of the Mountain Waters in Andalusia Sierra-Nevada Spain"	1973
"Lorite Moreno,Juan;Navarro Reyes,Francisco Bruno;Valle Tendero,Francisco"	"New records for the vascular flora of Sierra Nevada (Almeria): The Murciano-almeriense element"	1998
"Lorite,Juan;Algarra,Jose Antonio;Navarro,Francisco Bruno;Salazar,Carlos"	"Chorological notes on the vascular flora of Sierra Nevada, Almeria, Spain"	1999
"Lorite,Juan;Ruiz Girela,Mario;Donaire,Francisco"	"Data on endemic, rare or threatened flora of Sierra Nevada (SE. Spain)"	2005
"Lorite,Juan;Valle,Francisco;Ruiz Polo,Nieves"	"Cartography and vegetation dynamics in the Sierra Nevada, Almeria (s.e. Spain)"	1997
"Losa Quintana,J. M.;Perez Raya,F."	"The Rupicolous Communities of the Malacitano-Almijarense Sector of Sierra Nevada Granada Spain"	1986
"Lozez-Colon,Jose Ignacio"	"New data on Lucanidae and Melolonthidae from the Sierra Nevada (Iberian Peninsula) (Coleoptera)"	1992
"Lyneborg,L."	"Some Muscidae from Southern Spain with Descriptions of 6 New Species Insecta Diptera"	1970
"Macmillan,Craig W.;Costello,Michael J."	"A protocol for using a mite brushing machine for estimating densities of Willamette mite on grapes"	2005
"Martin,J.;Garcia-Barros,E.;Gurrea,P.;Lucianez,M. J.;Munguira,M. L.;Sanz,M. J.;Simon,J. C."	"High endemism areas in the Iberian Peninsula"	2000
"Martin,J.;Gurrea,P."	"Speciation areas in Spain and Portugal"	1999
"Martinez Rica,J. P."	"Diversity of alpine vertebrates in the Pyrenees and Sierra Nevada, Spain."	2003
"Martinez,R."	"Seasonal Variation of Phyto Plankton Biomass and Photosynthesis in the High Mountain Lake La-Caldera Sierra-Nevada Spain"	1980
"Martinez,R."	"Phyto Plankton Species Biomass and Diversity in Lake La-Caldera Sierra-Nevada Granada Spain"	1977
"Martinez,T."	"Comparison of the Alimentary Habits of the Wild Goat and Sheep in the Alpine Zone of Sierra Nevada Spain"	1988
"Martinez-Silvestre R"	"1st Report on the Limnology of the Alpine Lake La-Caldera in the Penibetic Mountains Sierra-Nevada Granada Spain"	1975
"Martinez-Silvestre R"	"Study of the Diatom Flora of the Alpine Lake Aguas-Verdes Sierra-Nevada Granada Spain by Light and Electron Microscopy"	1974
"Medina,Leopoldo"	"Sparganium angustifolium Michaux (Sparaganiaceae), a forgotten plant from Sierra Nevada (Granada)"	1998
"Michelsen,V."	"The Mediterranean Species of Pegoplata Section Cuticornis Diptera Anthomyiidae"	1988
"Montero,A. M.;Ranera,A. T."	"Phenology of the Vespidae in Sierra Nevada Granada Spain Hymenoptera Vespidae"	1987
"Mota,J. F.;Valle,F."	"New Data for the Flora of Sierra Nevada Andalusia Spain"	1986
"Munguira,M. L.;Martin,J."	"The Sierra Nevada Blue, Polyommatus golgus (Hubner)"	1993
"Nieto Feliner,Gonzalo"	"Notulae taxinomicae, chorologicae, nomenclaturales, bibliographicae aut philologicae in opus \"Flora Iberica\" intendentes: Are the yellow flowered and purple-violet-flowered orophilous Erysimum from the Sierra Nevada Mountain range conspecific?"	1992
"Nieto Feliner,Gonzalo;Gutierrez Larena,Belen;Fuertes Aguilar,Javier"	"Fine-scale geographical structure, intra-individual polymorphism and recombination in nuclear ribosomal internal transcribed spacers in Armeria (Plumbaginaceae)."	2004
"Nieto Feliner,Gonzalo;Rossello,Josep Antoni;Fuertes,Javier"	"A new subspecies of Armeria filicaulis (Plumbaginaceae) from Sierra Nevada (southern Spain)"	1998
"Novoa,Francisco;Baselga,Andres"	"[Carabidae of west central Rif; Morocco (Coleoptera)]"	1999
"Ocana,A.;Pena Santiago,R.;Hernandez Ruiz,J.;Morales Baquero,R."	"Nematodes of the order Dorylaimida (Pearse, 1942) in different high-mountain lakes of the Sierra Nevada (Granada, Spain)"	2002
"Olivares,Javier;Jutzeler,David;Leestmans,Ronny"	"Arethusana boabdil (Rambur, 1840) from Grenada, Andalusia: An excellent species (Lepidoptera: Nymphalidae: Satyrinae)"	1999
"Ortega Bernaldo De Quiros,E."	"Edaphoclimate of the South-Southeast Part of Sierra-Nevada Spain"	1984
"Ortega,A.;Buendia,A. G."	"Contribution to the Mycological Catalogue of the Sierra Nevada Granada Spain"	1986
"Pace,R."	"Some Therian and Maghrebian Species of Atheta of the Subgenus Microdota Coleoptera Staphylinidae 36th Contribution to the Aleocharinae"	1982
"Pardo Alcaide,A."	"Studies on Meloidae Coleoptera Part 24 a New Species of Mylabris Mylabris-Platai New-Species from the Sierra-Nevada Spain"	1975
"Parraga Martinez,J."	"The Soil of Repopulated Forests of Pinus-Sylvestris and Pinus-Uncinata of the Deep Valley of the Chico River Southern Versant of the Sierra Nevada Spain"	1985
"Parraga Martinez,J."	"The Influence of the Topography and Vegetation on Forest Soils of the Camarate Sierra-Nevada Spain"	1983
"Parraga Martinez,J.;Serrano Molina,E."	"The Xerumbrepts of Mountain Shrubbery from South Versant of Sierra Nevada Granada Spain"	1985
"Parraga,J.;Aguilar,J."	"Edaphological Study of the Dehesa of Camarate Sierra-Nevada Granada Spain 1. Macro and Micro Morphological Characteristics"	1981
"Pascual Torres,F."	"The Coprophagous Scarabaeoidea Coleoptera of the High Mountain Wet Grassland in Sierra Nevada Granada Spain"	1989
"Pascual Torres,F."	"Contribution to the Study of Coprophagic Scarabids from the Sierra Nevada Granada Spain Vi. Autecology of the Species of the Family Aphodiidae Coleoptera Scarabaeoidea"	1987
"Pascual,F."	"Description of a Male Eumigus-Rubioi Orthoptera Pamphagidae"	1981
"Pascual,F."	"Preliminary Study of Orthoptera of the Sierra-Nevada Spain 4. Altitude Distribution"	1978
"Pascual,F."	"Description of a New Species Ctenodecticus-Granatensis New-Species from the Sierra-Nevada Spain Orthoptera Tettigoniidae Decticinae"	1978
"Pascual,F."	"Description of a New Species Omocestus-Ilorenteae New-Species from the Sierra-Nevada Spain Orthoptera Acrididae Gomphocerinae"	1978
"Pascual,F."	"Chorthippus-Nevadensis New-Species from the Sierra-Nevada Spain Orthoptera Acrididae"	1978
"Pascual,F."	"Ctenodecticus-Major New-Species from Sierra-Nevada Spain Orthoptera Tettigoniidae"	1976
"Perez Lopez,F. Javier"	"Contribution to the knowledge of the noctuids of Sierra Nevada (Granada) (Lepidoptera: Noctuidae)"	1992
"Perez Lopez,Francisco Javier;Yela,Jose Luis"	"Genus Chersotis Boisduval, 1840 (Lepidoptera, Noctuidae) in Sierra Nevada (Granada, South of Spain): Faunistical, taxonomical, biogeographical and altitudinal datas"	1994
"Perez Lopez,Javier;Tinaut,Alberto"	"Diarsia guadarramensis, new record (Boursin, 1928) in the south of the Iberian Peninsula (Lepidoptera, Noctuidae)"	1992
"Perez Raya,F.;Casares Porcel,M."	"Palynological Study on the Genus Asplenium L. in Sierra Nevada Andalusia Spain"	1986
"Perez Raya,F.;Casares Porcel,M.;Jimenez Gonzalez,J."	"Palynological study of the genus Polypodium L. in the Sierra Nevada (Andalucia, Spain)"	1988
"Perez Raya,F.;Molero Mesa,J."	"Considerations on the Order Rosmarinetalia Br. Bl. 1931 1952 in the Sierra Nevada Granada Spain"	1988
"Perez,L."	"The Biochemical Diversity of Heterotrophic Bacterial Communities in High Mountain Lakes from Sierra Nevada Granada Spain"	1987
"Perez-Lopez,F. J.;Tinaut,A."	"The Noctuidae from Sierra Nevada (Granada) (Iberian Peninsula) (Lepidoptera: Noctuidae)"	1993
"Prieto,P.;Espinosa,P."	"Asco Lichens of the Cliffs of San-Francisco Sierra-Nevada Granada Part 1"	1971
"Puehringer,F.;Poell,N."	"A hitherto unknown male of Synansphecia kautzi (Reisser, 1930) (Lepidoptera, Sesiidae)"	1999
"Puehringer,Franz;Poell,Norbert"	"Notes on the biology of Synansphecia kautzi (REISSER, 1930) (Lepidoptera, Sesiidae)."	2004
"Remane,Reinhard;Holzinger,Werner E."	"Two new Cixius (Ceratocixius) species from south-western Palaearctic Region (Insecta: Homoptera: Auchenorrhyncha: Cixiidae)"	1998
"Roldan,A.;Descals,E.;Honrubia,M."	"Aquatic Hyphomycetes from Sierra Nevada and Sierra De Los Filabres South Spain"	1988
"Ruiz Rejon,C.;Lozano,R.;Ruiz Rejon,M."	"Polysomy and Supernumerary Chromosomes in Ornithogalum-Umbellatum L. Liliaceae"	1987
"Ruiz Rejon,C.;Ruiz Rejon,M."	"Chromosomal Polymorphism for a Heterochromatic Supernumerary Segment in a Natural Population of Tulipa-Australis Liliaceae"	1985
"Russell,William H.;McBride,Joe R.;Carnell,Ky"	"Influence of environmental factors on the regeneration of hardwood species on three streams in the Sierra Nevada."	2003
"Saint Girons,H."	"The Systematics of Vipera-Latastei-Latastei and a Description of Vipera-Latastei-Gaditana New-Subspecies Reptilia Viperidae"	1977
"Sainz Cantero,C. E.;Sanchez Ortega,A.;Alba Tercedor,J."	"Distribution and Autoecology of Hydraenidae in the Sierra Nevada Spain Insecta Coleoptera"	1987
"Sainz-Cantero C E;Zamora-Munoz C;Alba-Tercedor J"	"Aquatic Coleoptera from the Monachil River Sierra Nevada Granada Spain"	1988
"Sainz-Cantero,C. E.;Alba-Tercedor,J."	"Aquatic Adephaga from Sierra Nevada (Granada, Spain) (Coleoptera: Haliplidae, Gyrinidae, Dytiscidae)"	1991
"Sainz-Cantero,C. E.;Alba-Tercedor,J."	"Aquatic Polyphaga from Sierra Nevada (Granada, Spain) (Coleoptera: Hydraenidae, Hydrophilidae, Elmidae, Dryopidae)"	1991
"Sanchez-Castillo P M"	"Algae from High-Mountain Lagoons in the Sierra Nevada Granada Spain"	1988
"Sanchez-Maranon,R. Delgado;Parraga,J.;Delgado,G."	"Multivariate analysis in the quantitative evaluation of soils for reforestation in the Sierra Nevada, (southern Spain)"	1996
"Sanchez-Ortega a;Alba-Tercedor J"	"The Life Cycle of Perla-Marginata and Dinocras-Cephalotes in Sierra Nevada Granada Spain Plecoptera Perlidae"	1991
"Sanchez-Ortega a;Alba-Tercedor J"	"On the Nymphs of Isoperla-Nevada Aubert 1952 and Nemoura-Fulviceps Klapalek 1902 from the Sierra Nevada Spain Insecta Plecoptera"	1988
"Schippmann,U."	"Brachypodium-Boissieri Nyman an Endemic Grass Species of Southern Spain"	1990
"Schmidt-Koehl W"	"Butterfly Observations in Morocco Middle Atlas and in Southern Spain Sierra-Nevada in July August 1977 Insecta Lepidoptera"	1978
"Selga,D.;Simon,J. C.;Acon,M."	"Variations and Characteristics of the Terrestrial Micro Arthropod Fauna in Sierra-Nevada Spain"	1977
"Serve,L."	"A New Species from the Sierra-Nevada Southern Spain Iberis-Embergeri-D New Species"	1971
"Shaverdo,H. V."	"Revision of the nigrita-group of Hydroporus CLAIRVILLE, 1806 (Insecta: Coleoptera: Dytiscidae)"	2004
"Skartveit,John;Haenni,Jean-Paul"	"Three species of Bibionidae (Diptera) new to the fauna of Switzerland"	1997
"Soriano,Ignasi"	"[On Pedicularis verticillata (Scrophulariaceae) of the Sierra Nevada mountains, Spain.]"	2003
"Stace,Clive"	"Higher and earlier"	1992
"Steinmann,H."	"A Revision of the Genus Aborolabis Dermaptera Carcinophoridae"	1977
"Subias,L. S.;Arillo,A."	"Pluritrichoppia-Insolita New-Genus New-Species Acari Oribatida Oppiidae from the South of Spain"	1989
"Tarrier,Michel"	"Protection of the Sierra Nevada (Spain) habitats, Biosphere Reserve (UNESCO): The maximum level of destruction has been reached"	1996
"Tercedor,J. A."	"Ephemerella-Ikonomovi-Nevadensis New-Subspecies of Sierra-Nevada Spain Ephemeroptera Ephemerellidae"	1982
"Tierno de Figueroa,J. M.;Sanchez-Ortega,A."	"The male drumming call of Isoperla nevada Aubert, 1952 (Plecoptera, Perlodidae)"	1999
"Tierno De Figueroa,M.;Sanchez-Ortega,A.;Azzouz,M."	"Preliminary data on the numeric evolution of captures of various Plecoptera species (Insecta, Plecoptera) in Sierra Nevada (Granada, Spain) throughout their flight period"	1992
"Tinaut,A."	"Teleutomyrmex-Kutteri New-Species a New Species from Sierra Nevada Granada Spain Hymenoptera Formicidae"	1990
"Valle,F."	"Map of the Vegetation Series of the Sierra-Nevada Mountains Spain"	1985
"Van Den Berg,A. J. J."	"The White Flowered European Sedum Species 2. Cyto Taxonomic Notes on Sedum-Album and Sedum-Gypsicolum"	1982
"Velasco,Jose Luis;Araujo,Rafael;Alvarez,Miguel;Colomer,Manuel;Baltanas,Angel"	"Aportation to the limnological knowledge of eight mountain lakes and ponds in Asturias (Spain)"	1999
"Vivero,Jose Luis;Hernandez-Bermejo,J. Esteban;Ligero,Josefa Prados"	"Conservation strategies and management guidelines for wild Prunus genetic resources in Andalusia, Spain"	2001
"Weise,E."	"The Species of Isomira Coleoptera Alleculidae of Middle Europe and Places Situated in the Mediterranean Sea"	1974
"Werner,R. G."	"The Lichen Flora of the Betic-Rifa Cordillera Spain Phyto Geographic and Ecologic Study"	1979
"Wittmer,W."	"Contribution to the Knowledge of the Palearctic Cantharidae and Malachiidae Coleoptera"	1974
"Zamora,R."	"The Fruit Diet of Ring-Ouzels Turdus-Torquatus Wintering in the Sierra Nevada Southeast Spain"	1990
"Zamora,Regino;Gomez,Lorena;Gomez,Jose Maraa;Hodar,Jose Antonio;Baraza,Elena;Castro,Jorge"	"Meta-analysis of the nurse effect of shrubs in reforestations in Mediterranean mountains."	2002
"Zamora-Munoz,Carmen;Alba-Tercedor,Javier"	"First record of Halesus tessellatus Rambur, 1842 (Trichoptera: Limnephilidae) in the Iberian Peninsula"	1995
"[Anonymous]"	"Tenth annual meeting of the European Bone Marrow Transplantation Group 1984. Sierra Nevada (Granada), Spain, 29 January - 1 February 1984. Abstracts."	1984
"Duval,B.;Duval,E.;Hoham,R. W."	"Snow algae of the Sierra Nevada, Spain, and High Atlas mountains of Morocco."	1999
"Extremera Montero,F.;Moyano Acost,R.;Gomez Pozo,B.;Bermudez Ruiz,P.;Lopez Mendez,J.;Aguilar Rivas,S.;Ingelmo Martin,J."	"[Exposure to Mycobacterium tuberculosis during a bus travel]."	2001
"Francia Martinez,Jose R.;Duran Zuazo,Victor H.;Martinez Raya,Armando"	"Environmental impact from mountainous olive orchards under different soil-management systems (SE Spain)."	2006
"Palenzuela,Javier;Azcon-Aguilar,Concepcion;Barea,Jose-Miguel;da Silva,Gladstone Alves;Oehl,Fritz"	"Septoglomus altomontanum, a new arbuscular mycorrhizal fungus from mountainous and alpine areas in Andalucia (southern Spain)."	2013
"Perez-Luque,Antonio Jesus;Bonet,Francisco Javier;Perez-Perez,Ramon;Rut Aspizua;Lorite,Juan;Zamora,Regino"	"Sinfonevada: Dataset of Floristic diversity inSierraNevada forests (SE Spain)."	2014
"Perez-Luque,Antonio Jesus;Sanchez-Rojas,Cristina Patricia;Zamora,Regino;Perez-Perez,Ramon;Bonet,Francisco Javier"	"Dataset of Phenology of Mediterranean high-mountain meadows flora (Sierra Nevada, Spain)."	2015
"Perez-Luque,Antonio Jesus;Zamora,Regino;Bonet,Francisco Javier;Perez-Perez,Ramon"	"Dataset of MIGRAME Project (Global Change, Altitudinal Range Shift and Colonization of Degraded Habitats in Mediterranean Mountains)."	2015
"Tierno de Figueroa,J. M.;Luzon-Ortega,J. M.;Stewart,K. W."	"The drumming of Isoperla pallida Aubert and Guadalgenus franzi (Aubert) (Plecoptera, Perlodidae), and review and evolutionary considerations of Southern Iberian Peninsula Perlodidae."	2002
"Villar Del Fresno,A.;Cabo Torres,J."	"[Phytochemical study of Aconitum lycoctonum from Sierra Nevada. I. Quantitative determination of the alkaloid content]."	1973
"Acevedo,Pelayo;Cassinello,Jorge;Gortazar,Christian"	"The Iberian ibex is under an expansion trend but displaced to suboptimal habitats by the presence of extensive goat livestock in central Spain"	2007
"Achotegui-Castells,Ander;Llusia,Joan;Hodar,Jose A.;Penuelas,Josep"	"Needle terpene concentrations and emissions of two coexisting subspecies of Scots pine attacked by the pine processionary moth (Thaumetopoea pityocampa)"	2013
"Adjemian,Jennifer Zipser;Adjemian,Michael K.;Foley,Patrick;Chomel,Bruno B.;Kasten,Rickie W.;Foley,Janet E."	"Evidence of multiple zoonotic agents in a wild rodent community in the eastern sierra Nevada"	2008
"Alados-Arboledas,L.;Alcantara,A.;Olmo,F. J.;Martinez-Lozano,J. A.;Estelles,V.;Cachorro,V.;Silva,A. M.;Horvath,H.;Gangl,M.;Diaz,A.;Pujadas,M.;Lorente,J.;Labajo,A.;Sorribas,M.;Pavese,G."	"Aerosol columnar properties retrieved from CIMEL radiometers during VELETA 2002"	2008
"Alasaad,S.;Granados,J. E.;Cano-Manuel,F. J.;Meana,A.;Zhu,X. Q.;Perez,J. M."	"Epidemiology of fasciolosis affecting Iberian ibex (Capra pyrenaica) in southern Spain"	2008
"Alasaad,S.;Morrondo,P.;Dacal-Rivas,V.;Soriguer,R. C.;Granados,J. E.;Serrano,E.;Zhu,X. Q.;Rossi,L.;Perez,J. M."	"Bronchopulmonary nematode infection of Capra pyrenaica in the Sierra Nevada massif, Spain"	2009
"Alasaad,S.;Soglia,D.;Sarasa,M.;Soriguer,R. C.;Perez,J. M.;Granados,J. E.;Rasero,R.;Zhu,X. Q.;Rossi,L."	"Skin-scale genetic structure of Sarcoptes scabiei populations from individual hosts: empirical evidence from Iberian ibex-derived mites"	2008
"Alasaad,Samer;Granados,Jose E.;Fandos,Paulino;Cano-Manuel,Francisco-Javier;Soriguer,Ramon C.;Perez,Jesus M."	"The use of radio-collars for monitoring wildlife diseases: a case study from Iberian ibex affected by Sarcoptes scabiei in Sierra Nevada, Spain"	2013
"Alasaad,Samer;Jowers,Michael J.;Garrido-Garcia,Jose A.;Wandeler,Peter;Fickel,Joerns;Sanchez,Antonio;Soriguer,Ramon C."	"Noninvasive molecular and morphological evidences for an undiscovered population of snow vole in Southern Spain"	2013
"Alvarez-Ortega,Sergio;Pena-Santiago,Reyes"	"Nematodes of the order Dorylaimida from Andalucia Oriental, Spain. Nevadanema nevadense gen. n., sp n. (Qudsianematidae) from Sierra Nevada National Park"	2012
"Anderson,M. Kat;Rosenthal,Jeffrey"	"An Ethnobiological Approach to Reconstructing Indigenous Fire Regimes in the Foothill Chaparral of the Western Sierra Nevada"	2015
"Anderson,R. S.;Jimenez-Moreno,G.;Carrion,J. S.;Perez-Martinez,C."	"Postglacial history of alpine vegetation, fire, and climate from Laguna de Rio Seco, Sierra Nevada, southern Spain"	2011
"Andrade,L.;Gonzalez-Lopez,J.;Fenice,M.;Martinez-Toledo,M., V.;Pesciaroli,C.;Maza-Marquez,P.;Juarez-Jimenez,B."	"Application of Response Surface Methodology (RSM) for Culture Conditions and Biomass Production of Psychrophilic Microalgae Isolated from High Mountains Lake During the ice-free Season"	2014
"Antonio Delgado-Molina,Jose;Carrillo,Presentacion;Manuel Medina-Sanchez,Juan;Villar-Argaiz,Manuel;Jose Bullejos,Francisco"	"Interactive effects of phosphorus loads and ambient ultraviolet radiation on the algal community in a high-mountain lake"	2009
"Antunes,I. M. H. R.;Neiva,A. M. R.;Silva,M. M. V. G.;Corfu,F."	"The genesis of I- and S-type granitoid rocks of the Early Ordovician Oledo pluton, Central Iberian Zone (central Portugal)"	2009
"Arabaci,M. Ozbey;Camero-Arranz,A.;Zurita,C.;Gutierrez-Soto,J.;Nespoli,E.;Suso,J.;Kiaeerad,F.;Garcia-Rojas,J.;Kiziloglu,U."	"Detection of a large Be circumstellar disk during X-ray quiescence of XTE J1946+274"	2015
"Aranbarri,Josu K.;Gonzalez-Samperiz,Penelope;Valero-Garces,Bias;Moreno,Ana;Gil-Romera,Graciela;Sevilla-Callejo,Miguel;Garcia-Prieto,Eduardo;Di Rita,Federico;Mata,M. Pilar;Morellon,Mario;Magri,Donatella;Rodriguez-Lazaro,Julio;Carrion,Jose S."	"Rapid climatic changes and resilient vegetation during the Lateglacial and Holocene in a continental region of south-western Europe"	2014
"Aranda,V.;Oyonarte,C."	"Characterization of the organic matter of soil surface horizons in selected Mediterranean environments using IR spectroscopy"	2007
"Arboleya,Maria-Luisa;Babault,Julien;Owen,Lewis A.;Teixell,Antonio;Finkel,Robert C."	"Timing and nature of Quaternary fluvial incision in the Ouarzazate foreland basin, Morocco"	2008
"Ari Noriega,Jorge;Solis,Cesil;Garcia,Hector;Murillo-Ramos,Leidys;Manuel Renjifo,Juan;Eliecer Olarte,Jorge"	"Dung beetles (Coleoptera: Scarabaeinae) from the Caribbean Region of Colombia"	2013
"Arias,Maria Sol;Moreno,Virginia;Sarasa,Mathieu;Paz-Silva,Adolfo;Sanchez-Andrade,Rita;Morrondo,Patrocinio;Diez-Banos,Pablo;Granados,Jose E.;Sanchezjj,Antonio;Perez,Jeusus M."	"Reliability of an ELISA Test for Diagnosing Oestrosis in Iberian Ibex"	2014
"Azanon,J. M.;Galve,J. P.;Perez-Pena,J. V.;Giaconia,F.;Carvajal,R.;Booth-Rea,G.;Jabaloy,A.;Vazquez,M.;Azor,A.;Roldan,F. J."	"Relief and drainage evolution during the exhumation of the Sierra Nevada (SE Spain): Is denudation keeping pace with uplift?"	2015
"Azanon,J. M.;Perez-Pena,J. V.;Giaconia,F.;Booth-Rea,G.;Martinez-Martinez,J. M.;Rodriguez-Peces,M. J."	"Active tectonics in the central and eastern Betic Cordillera through morphotectonic analysis: the case of Sierra Nevada and Sierra Alhamilla"	2012
"Azor,Jairo S.;Santos,Xavier;Pleguezuelos,Juan M."	"Conifer-plantation thinning restores reptile biodiversity in Mediterranean landscapes"	2015
"Bagne,Karen E.;Purcell,Kathryn L."	"Short-Term Responses of Birds to Prescribed Fire in Fire-Suppressed Forests of California"	2011
"Bahrami,Shahram"	"Tectonic controls on the morphometry of alluvial fans around Danehkhoshk anticline, Zagros, Iran"	2013
"Bailen,Maria;Julio,Luis F.;Diaz,Carmen E.;Sanz,Jesus;Martinez-Diaz,Rafael A.;Cabrera,Raimundo;Burillo,Jesus;Gonzalez-Coloma,Azucena"	"Chemical composition and biological effects of essential oils from Artemisia absinthium L. cultivated under different environmental conditions"	2013
"Barrero,Alejandro F.;Mar Herrador del Pino,M.;Gonzalez Portero,Adriana;Arteaga Buron,Pilar;Arteaga,Jesus F.;Burillo Alquezar,Jesus;Elisa Diaz,Carmen;Gonzalez Coloma,Azucena"	"Terpenes and polyacetylenes from cultivated Artemisia granatensis boiss (Royal chamomile) and their defensive properties"	2013
"Batlles,F. J.;Bosch,J. L.;Tovar-Pescador,J.;Martinez-Durban,M.;Ortega,R.;Miralles,I."	"Determination of atmospheric parameters to estimate global radiation in areas of complex topography: Generation of global irradiation map"	2008
"Batllori,Enric;Camarero,J. Julio;Ninot,Josep M.;Gutierrez,Emilia"	"Seedling recruitment, survival and facilitation in alpine Pinus uncinata tree line ecotones. Implications and potential responses to climate warming"	2009
"Bats,Michel"	"The Phoceans, Marseilles and the Gaul (VII - III c. BC)"	2012
"Behr,W. M.;Platt,J. P."	"Kinematic and thermal evolution during two-stage exhumation of a Mediterranean subduction complex"	2012
"Benito,Blas;Lorite,Juan;Penas,Julio"	"Simulating potential effects of climatic warming on altitudinal patterns of key species in Mediterranean-alpine ecosystems"	2011
"Biber,Jani Leyla;McCann,Tom"	"Peperite development in a Miocene-age carbonate succession, Cabo de Gata volcanic area (Agua Amarga/Carboneras basins), SE Spain - The Breche Rouge revisited"	2014
"Blanco-Pastor,J. L.;Fernandez-Mazuecos,M.;Vargas,P."	"Past and future demographic dynamics of alpine species: limited genetic consequences despite dramatic range contraction in a plant from the Spanish Sierra Nevada"	2013
"Bonet,Francisco J.;Perez-Perez,Ramon;Benito,Bias M.;de Albuquerque,Fabio Suzart;Zamora,Regino"	"Documenting, storing, and executing models in Ecology: A conceptual framework and real implementation in a global change monitoring program"	2014
"Bonet-Garcia,Francisco J.;Perez-Perez,Ramon;Perez-Luque,Antonio J.;Magana-Redondo,Pedro J."	"An Ontological Indicator System Based on MODIS Images to Detect Changes in Habitats Functioning in Sierra Nevada (Spain) Natura 2000 Site"	2013
"Bosch,J. L.;Lopez,G.;Batlles,F. J."	"Daily solar irradiation estimation over a mountainous area using artificial neural networks"	2008
"Bullejos,F. J.;Villar-Argaiz,M.;Medina-Sanchez,J. M.;Delgado-Molina,J. A.;Carrillo,P."	"Impact of UV radiation and nutrients on the elemental composition of zooplankton in a Mediterranean high mountain lake"	2008
"Calvache,M. L.;Duque,C.;Gomez Fontalva,J. M.;Crespo,F."	"Processes affecting groundwater temperature patterns in a coastal aquifer"	2011
"Camero,A.;Zurita,C.;Gutierrez-Soto,J.;Ozbey Arabaci,M.;Nespoli,E.;Kiaeerad,F.;Beklen,E.;Garcia-Rojas,J.;Caballero-Garcia,M."	"Recent activity of the Be/X-ray binary system SAX J2103.5+4545"	2014
"Canadas,Eva M.;Fenu,Giuseppe;Penas,Julio;Lorite,Juan;Mattana,Efisio;Bacchetta,Gianluigi"	"Hotspots within hotspots: Endemic plant richness, environmental drivers, and implications for conservation"	2014
"Cano-Manuel,Francisco J.;Lopez-Olvera,Jorge;Fandos,Paulino;Soriguer,Ramon C.;Perez,Jesus M.;Granados,Jose E."	"Long-term monitoring of 10 selected pathogens in wild boar (Sus scrofa) in Sierra Nevada National Park, southern Spain"	2014
"Carinanos,Paloma;Diaz de la Guardia,Consuelo;Antonio Algarra,Jose;De Linares,Concepcion;Ma Irurita,Jose"	"The pollen counts as bioindicator of meteorological trends and tool for assessing the status of endangered species: the case of Artemisia in Sierra Nevada (Spain)"	2013
"Carvalho,Joao;Granados,Jose E.;Lopez-Olvera,Jorge R.;Javier Cano-Manuel,Francisco;Perez,Jesus M.;Fandos,Paulino;Soriguer,Ramon C.;Velarde,Roser;Fonseca,Carlos;Raez,Arian;Espinosa,Jose;Pettorelli,Nathalie;Serrano,Emmanuel"	"Sarcoptic mange breaks up bottom-up regulation of body condition in a large herbivore population"	2015
"Cas,Raymond A. F.;Giordano,Guido"	"Submarine Volcanism: a Review of the Constraints, Processes and Products, and Relevance to the Cabo de Gata Volcanic Succession"	2014
"Casas,J. Jesus;Gessner,Mark O.;Lopez,Dalila;Descals,Enrique"	"Leaf-litter colonisation and breakdown in relation to stream typology: insights from Mediterranean low-order streams"	2011
"Casas,J. Jesus;Langton,Peter H."	"Chironomid species richness of a permanent and a temporary Mediterranean stream: a long-term comparative study"	2008
"Castro,J.;Puerta-Pinero,C.;Leverkus,A. B.;Moreno-Rueda,G.;Sanchez-Miranda,A."	"Post-fire salvage logging alters a key plant-animal interaction for forest regeneration"	2012
"Castro,Jorge;Moreno-Rueda,Gregorio;Hodar,Jose A."	"Experimental Test of Postfire Management in Pine Forests: Impact of Salvage Logging versus Partial Cutting and Nonintervention on Bird-Species Assemblages"	2010
"Catry,F. X.;Rego,F.;Moreira,F.;Fernandes,P. M.;Pausas,J. G."	"Post-fire tree mortality in mixed forests of central Portugal"	2010
"Cepak,Vladislav;Lukavsky,Jaromir"	"Cryoseston in the Sierra Nevada Mountains (Spain)"	2011
"Chacon,Jose;Irigaray,Clemente;El Hamdouni,Rachid;Valverde-Palacios,Ignacio;Valverde-Espinosa,Ignacio;Calvo,Francisco;Jimenez-Peralvarez,Jorge;Chacon,Eva;Fernandez,Paz;Garrido,Jesus;Lamas,Francisco"	"Engineering and Environmental Geology of Granada and its Metropolitan Area (Spain)"	2012
"Clark,S. J. P.;Dempster,T. J."	"The record of tectonic denudation and erosion in an emerging orogen: an apatite fission-track study of the Sierra Nevada, southern Spain"	2009
"Cobo-Diaz,Jose F.;Martinez-Hidalgo,Pilar;Fernandez-Gonzalez,Antonio J.;Martinez-Molina,Eustoquio;Toro,Nicolas;Velazquez,Encarna;Fernandez-Lopez,Manuel"	"The endemic Genista versicolor from Sierra Nevada National Park in Spain is nodulated by putative new Bradyrhizobium species and a novel symbiovar (sierranevadense)"	2014
"Cobos,Guillermo;Frances,Miguel;Arenillas,Miguel"	"The ERHIN programme. Hydrological-nival modelling for the management of water resources in the Ebro basin"	2010
"Conde-Porcuna,Jose M.;Javier Valdes,Francisco;Romo,Susana;Perez-Martinez,Carmen"	"Ephippial and subitaneous egg abortion: relevance for an obligate parthenogenetic Daphnia population"	2011
"Cunniffe,R.;Castro-Tirado,A. J.;Jelinek,M.;Gorosabel,J.;Moline,B.;Garcia-Segura,F."	"Status of the Bootes-Ir Project at Osn for Grb Near-Ir Follow-Up"	2013
"Cunniffe,R.;Castro-Tirado,A. J.;Kubanek,P.;Jelinek,M.;Vitek,S.;Gorosabel,J.;Postigo,A. de Ugarte;Riva,A.;Zerbi,F.;Claret,A.;Sanchez-Fernandez,C."	"Installation and first light of the BOOTES-IR near-IR camera"	2008
"Das,Adrian"	"The effect of size and competition on tree growth rate in old-growth coniferous forests"	2012
"de Galdeano,C. Sanz"	"Fracture controls in Tablate (Lecrin, Granada, Betic Chain, Spain)"	2008
"de Magalhaes,Rita M. Q.;Schwilk,Dylan W."	"Leaf traits and litter flammability: evidence for non-additive mixture effects in a temperate forest"	2012
"de Matias Bejarano,Javier;Moreno del Pozo,Jose;Guerrero Campo,Jose J."	"A multi-view dense reconstruction for rock glacier modelling"	2009
"De Matias,J.;Guerrero,J. J.;Moreno,J.;De Sanjose,J. J."	"Image Measurement Techniques in Rock Glacier Modelling"	2010
"de Matias,Javier;Juan de Sanjose,Jose;Lopez-Nicolas,Gonzalo;Saguees,Carlos;Jesus Guerrero,Jose"	"Photogrammetric Methodology for the Production of Geomorphologic Maps: Application to the Veleta Rock Glacier (Sierra Nevada, Granada, Spain)"	2009
"De Sanjose,J. J.;Berenguer,F.;Atkinson,A. D. J.;De Matias,J.;Serrano,E.;Gomez-Ortiz,A.;Gonzalez-Garcia,M.;Rico,I."	"Geomatics Techniques Applied to Glaciers, Rock Glaciers, and Ice Patches in Spain (1991-2012)"	2014
"de Sanjose-Blasco,Jose Juan;Atkinson-Gordo,Alan D. J.;Salvador-Franch,Ferran;Gomez-Ortiz,Antonio"	"Application of geomatic techniques to monitoring of the dynamics and to mapping of the Veleta rock glacier (Sierra Nevada, Spain)"	2007
"de Vicente,Inmaculada;Andersen,Frede Ostergaard;Hansen,Hans Christian Bruun;Cruz-Pizarro,Luis;Jensen,Henning Skovgaard"	"Water level fluctuations may decrease phosphate adsorption capacity of the sediment in oligotrophic high mountain lakes"	2010
"de Vicente,Inmaculada;Guerrero,Francisco;Jimenez-Gomez,Francisco;Cruz-Pizarro,Luis"	"Settling and resuspended particles: A source or a sink of phosphate in two contrasting oligotrophic high mountain lakes?"	2010
"Delgado-Molina,J. A.;Medina-Sanchez,J. M.;Villar-Argaiz,M.;Bullejos-Carrillo,F. J.;Carrillo,P."	"Induced algal community changes by UV radiation and nutrient inputs: A long-term experimental study in Lake La Caldera (Sierra Nevada, Spain)"	2009
"Diaz-Miguel,M.;Castro,J.;Garcia,P. A."	"Seed germination after freezing in high-mountain plant species: Implications for ski-run restoration"	2014
"Duran Zuazo,Victor Hugo;Francia Martinez,Jose Ramon;Garcia Tejero,Ivan;Rodriguez Pleguezuelo,Carmen Rocio;Martinez Raya,Armando;Cuadros Tavira,Simon"	"Runoff and sediment yield from a small watershed in southeastern Spain (Lanjaron): implications for water quality"	2012
"El Hamdouni,R.;Irigaray,C.;Fernandez,T.;Chacon,J.;Keller,E. A."	"Assessment of relative active tectonics, southwest border of the Sierra Nevada (southern Spain)"	2008
"Eyer,P. A.;Leniaud,L.;Darras,H.;Aron,S."	"Hybridogenesis through thelytokous parthenogenesis in two Cataglyphis desert ants"	2013
"Farines,Bernard;Calvet,Marc;Gunnell,Yanni"	"The summit erosion surfaces of the inner Betic Cordillera: Their value as tools for reconstructing the chronology of topographic growth in southern Spain"	2015
"Fernandes,Paulo M.;Luz,Ana;Loureiro,Carlos"	"Changes in wildfire severity from maritime pine woodland to contiguous forest types in the mountains of northwestern Portugal"	2010
"Fernandez Calzado,M. R.;Molero Mesa,J.;Merzouki,A.;Casares Porcel,M."	"Vascular plant diversity and climate change in the upper zone of Sierra Nevada, Spain"	2012
"Fernandez Calzado,Ma Rosa;Molero Mesa,Joaquin;Merzouki,Abderrahmane"	"Monitoring plant diversity and climatic change in Sierra Nevada (Spain)"	2010
"Fernandez Prieto,Jose Antonio;Molero Mesa,Joaquin;Perez Suarez,Marta;Sanna,Mauro;Munoz Diaz,Jose Miguel;Cires,Eduardo"	"Are they different species or vicariant elevational races of the same species? The case of an Iberian endemic plant, Ranunculus bupleuroides (Ranunculaceae)"	2015
"Fernandez,Carlos;Czeck,Dyanna M.;Diaz-Azpiroz,Manuel"	"Testing the model of oblique transpression with oblique extrusion in two natural cases: Steps and consequences"	2013
"Fernandez-Ramos,C.;Ballesteros,O.;Blanc,R.;Zafra-Gomez,A.;Camino-Sanchez,F. J.;Navalon,A.;Vilchez,J. L."	"Determination of alcohol sulfates and alcohol ethoxysulfates in marine and river sediments using liquid chromatography-tandem mass spectrometry"	2013
"Figueroa,Felix L.;Korbee,Nathalie;Carrillo,Presentacion;Manuel Medina-Sanchez,Juan;Mata,Mayte;Bonomi,Jose;Sanchez-Castillo,Pedro M."	"The effects of UV radiation on photosynthesis estimated as chlorophyll fluorescence in Zygnemopsis decussata (Chlorophyta) growing in a high mountain lake (Sierra Nevada, Southern Spain)"	2009
"Finn,Debra S.;Zamora-Munoz,Carmen;Murria,Cesc;Sainz-Bariain,Marta;Alba-Tercedor,Javier"	"Evidence from recently deglaciated mountain ranges that Baetis alpinus (Ephemeroptera) could lose significant genetic diversity as alpine glaciers disappear"	2014
"Fletcher,William J.;Debret,Maxime;Goni,Maria Fernanda Sanchez"	"Mid-Holocene emergence of a low-frequency millennial oscillation in western Mediterranean climate: Implications for past dynamics of the North Atlantic atmospheric westerlies"	2013
"Fletcher,William J.;Goni,Maria Fernanda Sanchez"	"Orbital- and sub-orbital-scale climate impacts on vegetation of the western Mediterranean basin over the last 48,000 yr"	2008
"Fontana,Anne-Laure;Boucher,Catherine;Serres,Patrice;Bortolotti,Yves;Cope,Florence;Stil,Irvin;Lefranc,Bastien;Garnier,Olivier;Butin,Gilles;Mattiocco,Francois;Navarro,Santiago;John,Dave;Navarrini,Alessandro;Schuster,Karl-F"	"A 3mm multipixel SIS receiver for IRAM 30-m Pico Veleta Telescope"	2012
"Fornieles-Callejon,J.;Salinas,A.;Toledo-Redondo,S.;Porti,J.;Mendez,A.;Navarro,E. A.;Morente-Molinera,J. A.;Soto-Aranaz,C.;Ortega-Cayuela,J. S."	"Extremely low frequency band station for natural electromagnetic noise measurement"	2015
"Fuertes Aguilar,Javier;Gutierrez Larena,Belen;Nieto Feliner,Gonzalo"	"Genetic and morphological diversity in Armeria (Plumbaginaceae) is shaped by glacial cycles in Mediterranean refugia"	2011
"Galiano,L.;Martinez-Vilalta,J.;Lloret,F."	"Drought-Induced Multifactor Decline of Scots Pine in the Pyrenees and Potential Vegetation Change by the Expansion of Co-occurring Oak Species"	2010
"Galindo-Zaldivar,J.;Gil,A. J.;Sanz de Galdeano,C.;Lacy,M. C.;Garcia-Armenteros,J. A.;Ruano,P.;Ruiz,A. M.;Martinez-Martos,M.;Alfaro,P."	"Active shallow extension in central and eastern Betic Cordillera from CGPS data"	2015
"Garcia-Alix,A.;Delgado Huertas,A.;Martin Suarez,E."	"Unravelling the Late Pleistocene habitat of the southernmost woolly mammoths in Europe"	2012
"Garcia-Alix,A.;Jimenez-Espejo,F. J.;Lozano,J. A.;Jimenez-Moreno,G.;Martinez-Ruiz,F.;Garcia Sanjuan,L.;Aranda Jimenez,G.;Garcia Alfonso,E.;Ruiz-Puertas,G.;Anderson,R. Scott"	"Anthropogenic impact and lead pollution throughout the Holocene in Southern Iberia"	2013
"Garcia-Alix,Antonio;Jimenez-Moreno,Gonzalo;Scott Anderson,R.;Jimenez Espejo,Francisco J.;Delgado Huertas,Antonio"	"Holocene environmental change in southern Spain deduced from the isotopic record of a high-elevation wetland in Sierra Nevada"	2012
"Garcia-Alix,Antonio;Minwer-Barakat,Raef;Martin Suarez,Elvira;Freudenthal,Matthijs;Delgado Huertas,Antonio"	"Cinnabar mineralization in fossil small mammal remains as a consequence of diagenetic processes"	2013
"Garcia-Jurado,Fatima;de Vicente,Inmaculada;Galotti,Andrea;Reul,Andreas;Jimenez-Gomez,Francisco;Guerrero,Francisco"	"Effect of Drought Conditions on Plankton Community and on Nutrient Availability in an Oligotrophic High Mountain Lake"	2012
"Garcia-Jurado,Fatima;Jimenez-Gomez,Francisco;Guerrero,Francisco"	"Effects of a dry period on the limnological characteristics of a Mediterranean high mountain lake"	2011
"Garcia-Lopez,S.;Benavente,J.;Cruz-Sanjulian,J. J.;Olias,M."	"Conjunctive use of water resources as an alternative to a leaky reservoir in a mountainous, semiarid area (Adra River basin, SE Spain)"	2009
"Garcia-Nieto,Ana P.;Garcia-Llorente,Marina;Iniesta-Arandia,Irene;Martin-Lopez,Berta"	"Mapping forest ecosystem services: From providing units to beneficiaries"	2013
"Garcia-Ruiz,Jose M.;Palacios,David;de Andres,Nuria;Valero-Garces,Blas L.;Lopez-Moreno,Juan I.;Sanjuan,Yasmina"	"Holocene and 'Little Ice Age' glacial activity in the Marbore Cirque, Monte Perdido Massif, Central Spanish Pyrenees"	2014
"Gilgado,Jose D.;Enghoff,Henrik;Tinaut,Alberto;Mauries,Jean-Paul;Ortuno,Vicente M."	"Sierra Nevada (Granada, Spain): a high-altitude biogeographical crossroads for millipedes (Diplopoda), with first data on its MSS fauna and description of a new species of the genus Ceratosphys Ribaut, 1920 (Chordeumatida: Opisthocheiridae)"	2015
"Gilgado,Jose D.;Enghoff,Henrik;Tinaut,Alberto;Ortuno,Vicente M."	"Hidden biodiversity in the Iberian Mesovoid Shallow Substratum (MSS): New and poorly known species of the millipede genus Archipolydesmus Attems, 1898 (Diplopoda, Polydesmidae)"	2015
"Gomez Ortiz,Antonio;Palacios,David;Palade,Bogdan;Vazquez Selem,Lorenzo;Salvador Franch,Ferran;Tanarro Garcia,Luis Miguel;Oliva Franganillo,Marc"	"Glacial Evolution of Sierra Nevada (Spain) and the Origin of Rock Glaciares"	2013
"Gomez Ortiz,Antonio;Salvador Franch,Ferran;Schulte,Lothar;Sanjose Blasco,Jose Juan;Atkinson Gordo,Alan;Palacios Estremera,David"	"Morphodynamic evolution in recent deglaciated high mountain areas: The case of the Veleta Cirque, Sierra Nevada. Consequence of climate change?"	2008
"Gomez,Jose M.;Abdelaziz,Mohamed;Lorite,Juan;Jesus Munoz-Pajares,A.;Perfectti,Francisco"	"Changes in pollinator fauna cause spatial variation in pollen limitation"	2010
"Gomez,Jose M.;Bosch,Jordi;Perfectti,Francisco;Fernandez,J. D.;Abdelaziz,Mohamed;Camacho,J. P. M."	"Spatial variation in selection on corolla shape in a generalist plant is promoted by the preference patterns of its local pollinators"	2008
"Gomez,Jose M.;Gonzalez-Megias,Adela;Lorite,Juan;Abdelaziz,Mohamed;Perfectti,Francisco"	"The silent extinction: climate change and the potential hybridization-mediated extinction of endemic high-mountain plants"	2015
"Gomez,Jose M.;Hodar,Jose A."	"Wild boars (Sus scrofa) affect the recruitment rate and spatial distribution of holm oak (Quercus ilex)"	2008
"Gomez,Jose M.;Perfectti,Francisco"	"Fitness consequences of centrality in mutualistic individual-based networks"	2012
"Gomez,Jose M.;Puerta-Pinero,Carolina;Schupp,Eugene W."	"Effectiveness of rodents as local seed dispersers of Holm oaks"	2008
"Gomez-Aparicio,Lorena;Zamora,Regino;Castro,Jorge;Hodar,Jose A."	"Facilitation of tree saplings by nurse plants: Microhabitat amelioration or protection against herbivores?"	2008
"Gomez-Aparicio,Lorena;Zavala,Miguel A.;Bonet,Francisco J.;Zamora,Regino"	"Are pine plantations valid tools for restoring Mediterranean forests? An assessment along abiotic and biotic gradients"	2009
"Gomez-Gutierrez,Alvaro;Juan de Sanjose-Blasco,Jose;de Matias-Bejarano,Javier;Berenguer-Sempere,Fernando"	"Comparing Two Photo-Reconstruction Methods to Produce High Density Point Clouds and DEMs in the Corral del Veleta Rock Glacier (Sierra Nevada, Spain)"	2014
"Gomez-Gutierrez,Alvaro;Juan de Sanjose-Blasco,Jose;Lozano-Parra,Javier;Berenguer-Sempere,Fernando;de Matias-Bejarano,Javier"	"Does HDR Pre-Processing Improve the Accuracy of 3D Models Obtained by Means of two Conventional SfM-MVS Software Packages? The Case of the Corral del Veleta Rock Glacier"	2015
"Gomez-Ortiz,A.;Oliva,M.;Salvador-Franch,F.;Salva-Catarineu,M.;Palacios,D.;de Sanjose-Blasco,J. J.;Tanarro-Garcia,L. M.;Galindo-Zaldivar,J.;de Galdeano,C. Sanz"	"Degradation of buried ice and permafrost in the Veleta cirque (Sierra Nevada, Spain) from 2006 to 2013 as a response to recent climate trends"	2014
"Gomez-Ortiz,Antonio;Oliva,Marc;Salva-Catarineu,Montserrat;Salvador-Franch,Ferran"	"The environmental protection of landscapes in the high semiarid Mediterranean mountain of Sierra Nevada National Park (Spain): Historical evolution and future perspectives"	2013
"Gomez-Ortiz,Antonio;Oliva-Franganillo,Marc;Salva-Catarineu,Montserrat;Salvador-Franch,Ferran"	"Landscape as a heritage resource in protected areas: the case of Sierra Nevada National Park (Spain)"	2010
"Gomez-Ortiz,Antonio;Palacios,David;Palade,Bogdan;Vazquez-Selem,Lorenzo;Salvador-Franch,Ferran"	"The deglaciation of the Sierra Nevada (Southern Spain)"	2012
"Gomez-Ortiz,Antonio;Palacios,David;Schulte,Lothar;Salvador-Franch,Ferran;Plana-Castellvi,Josep A."	"Evidences from Historical Documents of Landscape Evolution After Little Ice Age of a Mediterranean High Mountain Area, Sierra Nevada, Spain (Eighteenth to Twentieth Centuries)"	2009
"Gomez-Pugnaire,M. T.;Rubatto,D.;Fernandez-Soler,J. M.;Jabaloy,A.;Lopez-Sanchez-Vizcaino,V.;Gonzalez-Lodeiro,F.;Galindo-Zaldivar,J.;Padron-Navarta,J. A."	"Late Variscan magmatism in the Nevado-Filabride Complex: U-Pb geochronologic evidence for the pre-Mesozoic nature of the deepest Betic complex (SE Spain)"	2012
"Gonzalez-Gonzalez,E. A.;Gonzalez-Perez,M. A.;Rivero,E.;Sosa,P. A."	"Isolation and characterization of microsatellite loci in Sorbus aria (Rosaceae)"	2010
"Gonzalez-Megias,Adela;Maria Gomez,Jose;Sanchez-Pinero,Francisco"	"Spatio-temporal change in the relationship between habitat heterogeneity and species diversity"	2011
"Gonzalez-Megias,Adela;Maria Gomez,Jose;Sanchez-Pinero,Francisco"	"Factors determining beetle richness and composition along an altitudinal gradient in the high mountains of the Sierra Nevada National Park (Spain)"	2008
"Grayson,Donald K.;Millar,Constance I."	"Prehistoiric human influence on the abundance and distiribution of deadwood in alpine landscapes"	2008
"Guareschi,S.;Gutierrez-Canovas,C.;Picazo,F.;Sanchez-Fernandez,D.;Abellan,P.;Velasco,J.;Millan,A."	"Aquatic macroinvertebrate biodiversity: patterns and surrogates in mountainous Spanish national parks"	2012
"Helbling,E. W.;Carrillo,P.;Medina-Sanchez,J. M.;Duran,C.;Herrera,G.;Villar-Argaiz,M.;Villafane,V. E."	"Interactive effects of vertical mixing, nutrients and ultraviolet radiation: in situ photosynthetic responses of phytoplankton from high mountain lakes in Southern Europe"	2013
"Herrero,Asier;Castro,Jorge;Zamora,Regino;Delgado-Huertas,Antonio;Querejeta,Jose I."	"Growth and stable isotope signals associated with drought-related mortality in saplings of two coexisting pine species"	2013
"Herrero,J.;Polo,M. J."	"Parameterization of atmospheric longwave emissivity in a mountainous site for all sky conditions"	2012
"Herrero,J.;Polo,M. J.;Monino,A.;Losada,M. A."	"An energy balance snowmelt model in a Mediterranean site"	2009
"Herrero,Javier;Polo,Maria J.;Losada,Miguel A."	"Snow evolution in Sierra Nevada (Spain) from an energy balance model validated with Landsat TM data"	2011
"Ho,Winnie W.;Connolly,Sara G.;Reynolds,Pamela L.;Cornelius,Jamie M.;MacDougall-Shackleton,Elizabeth A.;Morton,Martin L.;Pereyra,Maria E.;Hahn,Thomas P."	"Song exposure during juvenile dispersal in Mountain White-crowned Sparrows"	2014
"Hodar,Jose A.;Torres-Muros,Lucia;Senhadji,Karim"	"Timing and intensity of bush cricket predation on egg batches of pine processionary moth: no evidence of population control"	2013
"Hodar,Jose A.;Torres-Muros,Lucia;Zamora,Regino;Perez-Luque,Antonio J.;Senhadji,Karim"	"No evidence of induced defence after defoliation in three pine species against an expanding pest, the pine processionary moth"	2015
"Huertegn,Jochen;Rudersdorf,Andreas;Gruetzner,Christoph;Reicherter,Klaus"	"Morphotectonics of the Padul-Niguelas Fault Zone, southern Spain"	2013
"Ibanez-Alamo,Juan D.;Soler,Manuel"	"Eurasian Sparrowhawk (Accipiter Nisus) as Predator of Eurasian Blackbird (Turdus Merula) Nests"	2012
"Iniesta-Arandia,Irene;Garcia-Llorente,Marina;Aguilera,Pedro A.;Montes,Carlos;Martin-Lopez,Berta"	"Socio-cultural valuation of ecosystem services: uncovering the links between values, drivers of change, and human well-being"	2014
"Israelevich,P.;Ganor,E.;Alpert,P.;Kishcha,P.;Stupp,A."	"Predominant transport paths of Saharan dust over the Mediterranean Sea to Europe"	2012
"Ivkovic,Marija;Zamora-Munoz,Carmen;Sainz-Bariain,Marta;Sinclair,Bradley J."	"Aquatic Empididae (Diptera: Hemerodromiinae and Clinocerinae) of the Sierra Nevada, Spain, with the description of five new species"	2014
"Jabaloy-Sanchez,Antonio;Teresa Gomez-Pugnaire,Maria;Padron-Navarta,Jose Alberto;Lopez Sanchez-Vizcaino,Vicente;Garrido,Carlos J."	"Subduction- and exhumation-related structures preserved in metaserpentinites and associated metasediments from the Nevado-Filabride Complex (Betic Cordillera, SE Spain)"	2015
"Javier Zamora-Camacho,Francisco;Reguera,Senda;Virtudes Rubino-Hispan,Maria;Moreno-Rueda,Gregorio"	"Eliciting an immune response reduces sprint speed in a lizard"	2015
"Javier Zamora-Camacho,Francisco;Virtudes Rubino-Hispan,Maria;Reguera,Senda;Moreno-Rueda,Gregorio"	"Thermal dependence of sprint performance in the lizard Psammo-dromus algirus along a 2200-meter elevational gradient: Cold-habitat lizards do not perform better at low temperatures"	2015
"Jesus Lopez-Rodriguez,Manuel;Miguel Luzon-Ortega,Julio;Manuel Tierno de Figueroa,Jose"	"On the biology of two high mountain populations of stoneflies (Plecoptera, Perlodidae) in the southern Iberian Peninsula"	2012
"Jesus Mendoza-Fernandez,Antonio;Javier Perez-Garcia,Francisco;Martinez-Hernandez,Fabian;Salmeron-Sanchez,Esteban;Miguel Medina-Cazorla,Jose;Antonio Garrido-Becerra,Juan;Isabel Martinez-Nieto,Maria;Encarna Merlo,Maria;Francisco Mota,Juan"	"Areas of endemism and threatened flora in a Mediterranean hotspot: Southern Spain"	2015
"Jesus Munoz-Pajares,A.;Belen Herrador,M.;Abdelaziz,Mohamed;Xavier Pico,F.;Sharbel,Timothy F.;Gomez,Jose M.;Perfectti,Francisco"	"Characterization of Microsatellite Loci in Erysimum Mediohispanicum (Brassicaceae) and Cross-Amplification in Related Species"	2011
"Jesus Perez-Luque,Antonio;Javier Bonet,Francisco;Perez-Perez,Ramon;Aspizua,Rut;Lorite,Juan;Zamora,Regino"	"Sinfonevada: Dataset of Floristic diversity in Sierra Nevada forests (SE Spain)"	2014
"Jesus Perez-Luque,Antonio;Miguel Barea-Azcon,Jose;Alvarez-Ruiz,Lola;Javier Bonet-Garcia,Francisco;Zamora,Regino"	"Dataset of Passerine bird communities in a Mediterranean high mountain (Sierra Nevada, Spain)"	2016
"Jesus Perez-Luque,Antonio;Patricia Sanchez-Rojas,Cristina;Zamora,Regino;Perez-Perez,Ramon;Javier Bonet,Francisco"	"Dataset of Phenology of Mediterranean high-mountain meadows flora (Sierra Nevada, Spain)"	2015
"Jesus Perez-Luque,Antonio;Zamora,Regino;Javier Bonet,Francisco;Perez-Perez,Ramon"	"Dataset of MIGRAME Project (Global Change, Altitudinal Range Shift and Colonization of Degraded Habitats in Mediterranean Mountains)"	2015
"Jimenez Olivencia,Yolanda;Porcel Rodriguez,Laura;Caballero Calvo,Andres"	"A Half-Century of Landscape Evolution in the Sierra Nevada (Spain)"	2015
"Jimenez,Laura;Romero-Viana,Lidia;Maria Conde-Porcuna,Jose;Perez-Martinez,Carmen"	"Sedimentary photosynthetic pigments as indicators of climate and watershed perturbations in an alpine lake in southern Spain"	2015
"Jimenez-Espejo,F. J.;Garcia-Alix,A.;Jimenez-Moreno,G.;Rodrigo-Gamiz,M.;Anderson,R. S.;Rodriguez-Tovar,F. J.;Martinez-Ruiz,F.;Giralt,Santiago;Delgado Huertas,A.;Pardo-Iguzquiza,E."	"Saharan aeolian input and effective humidity variations over western Europe during the Holocene from a high altitude record"	2014
"Jimenez-Moreno,Gonzalo;Alcicek,Huelya;Alcicek,M. Cihat;Ostende,Lars van den Hoek;Wesselingh,Frank P."	"Vegetation and climate changes during the late Pliocene and early Pleistocene in SW Anatolia, Turkey"	2015
"Jimenez-Moreno,Gonzalo;Anderson,R. Scott"	"Holocene vegetation and climate change recorded in alpine bog sediments from the Borreguiles de la Virgen, Sierra Nevada, southern Spain"	2012
"Jimenez-Moreno,Gonzalo;Garcia-Alix,Antonio;Dolores Hernandez-Corbalan,Maria;Anderson,R. Scott;Delgado-Huertas,Antonio"	"Vegetation, fire, climate and human disturbance history in the southwestern Mediterranean area during the late Holocene"	2013
"Jimenez-Peralvarez,J. D.;Irigaray,C.;El Hamdouni,R.;Chacon,J."	"Landslide-susceptibility mapping in a semi-arid mountain environment: an example from the southern slopes of Sierra Nevada (Granada, Spain)"	2011
"Jose Bullejos,Francisco;Carrillo,Presentacion;Gorokhova,Elena;Manuel Medina-Sanchez,Juan;Villar-Argaiz,Manuel"	"Nucleic Acid Content in Crustacean Zooplankton: Bridging Metabolic and Stoichiometric Predictions"	2014
"Jose Bullejos,Francisco;Carrillo,Presentacion;Villar-Argaiz,Manuel;Manuel Medina-Sanchez,Juan"	"Roles of phosphorus and ultraviolet radiation in the strength of phytoplankton-zooplankton coupling in a Mediterranean high mountain lake"	2010
"Jose Polo,Maria;Herrero,Javier;Aguilar,Cristina;Millares,Agustin;Monino,Antonio;Nieto,Sergio;Losada,Miguel A."	"WiMMed, a distributed physically-based watershed model (I): Description and validation"	2010
"Julio,Luis F.;Burillo,Jesus;Gimenez,Cristina;Cabrera,Raimundo;Diaz,Carmen E.;Sanz,Jesus;Gonzalez-Coloma,Azucena"	"Chemical and biocidal characterization of two cultivated Artemisia absinthium populations with different domestication levels"	2015
"Kefauver,Shawn C.;Penuelas,Josep;Ustin,Susan"	"Using topographic and remotely sensed variables to assess ozone injury to conifers in the Sierra Nevada (USA) and Catalonia (Spain)"	2013
"Kefauver,Shawn C.;Penuelas,Josep;Ustin,Susan L."	"Improving assessments of tropospheric ozone injury to Mediterranean montane conifer forests in California (USA) and Catalonia (Spain) with GIS models related to plant water relations"	2012
"Kefauver,Shawn C.;Penuelas,Josep;Ustin,Susan L."	"Applications of Hyperspectral Remote Sensing and Gis for Assessing Forest Health and Air Pollution"	2012
"Knapp,Eric E."	"Long-term dead wood changes in a Sierra Nevada mixed conifer forest: Habitat and fire hazard implications"	2015
"Kohfahl,Claus;Sprenger,Christoph;Benavente Herrera,Jose;Meyer,Hanno;Fernandez Chacon,Franzisca;Pekdeger,Asaf"	"Recharge sources and hydrogeochemical evolution of groundwater in semiarid and karstic environments: A field study in the Granada Basin (Southern Spain)"	2008
"Kottmann,Sina Lucia"	"Mocking and Miming the 'Moor': Staging of the 'Self' and 'Other' on Spain's Borders with Morocco"	2011
"Kropf,Matthias;Comes,Hans P.;Kadereit,Joachim W."	"Causes of the genetic architecture of south-west European high mountain disjuncts"	2008
"Kropf,Matthias;Comes,Hans Peter;Kadereit,Joachim W."	"An AFLP clock for the absolute dating of shallow-time evolutionary history based on the intraspecific divergence of southwestern European alpine plant species"	2009
"Lara,Francisco;Medina,Rafael;Garilleti,Ricardo;Mazimpaka,Vicente"	"On the presence of Orthotrichum patens Bruch & Brid. in the Iberian Peninsula"	2008
"Lee,Wei-Liang;Liou,K. N."	"Effect of absorbing aerosols on snow albedo reduction in the Sierra Nevada"	2012
"Lei,Shufei;Iles,Alastair;Kelly,Maggi"	"Characterizing the Networks of Digital Information that Support Collaborative Adaptive Forest Management in Sierra Nevada Forests"	2015
"Leon,Stephane;Espigares,Victor;Enrique Ruiz,Jose;Verdes-Montenegro,Lourdes;Mauersberger,Rainer;Brunswig,Walter;Kramer,Carsten;de Dios Santander-Vela,Juan;Wiesemeyer,Helmut"	"TAPAS, a VO archive at the IRAM 30-m telescope"	2012
"Leverkus,Alexandro B.;Castro,Jorge;Delgado-Capel,Manuel J.;Molinas-Gonzalez,Carlos;Pulgar,Manuel;Maranon-Jimenez,Sara;Delgado-Huertas,Antonio;Querejeta,Jose I."	"Restoring for the present or restoring for the future: enhanced performance of two sympatric oaks (Quercus ilex and Quercus pyrenaica) above the current forest limit"	2015
"Leverkus,Alexandro B.;Lorite,Juan;Navarro,Francisco B.;Sanchez-Canete,Enrique P.;Castro,Jorge"	"Post-fire salvage logging alters species composition and reduces cover, richness, and diversity in Mediterranean plant communities"	2014
"Leverkus,Alexandro B.;Rojo,Manuel;Castro,Jorge"	"Habitat complexity and individual acorn protectors enhance the post-fire restoration of oak forests via seed sowing"	2015
"Liao,Jau-Chyn;Valenzuela-Rios,Jose I."	"Upper Givetian and Frasnian (Middle and Upper Devonian) conodonts from Ampriu (Aragonian Pyrenees, Spain): global correlations and palaeogeographic relations"	2012
"Lihova,Judita;Carlsen,Tor;Brochmann,Christian;Marhold,Karol"	"Contrasting phylogeographies inferred for the two alpine sister species Cardamine resedifolia and C-alpina (Brassicaceae)"	2009
"Linares,Juan Carlos;Senhadji,Karim;Herrero,Asier;Hodar,Jose A."	"Growth patterns at the southern range edge of Scots pine: Disentangling the effects of drought and defoliation by the pine processionary caterpillar"	2014
"Lopez Sanchez-Vizcaino,Vicente;Teresa Gomez-Pugnaire,Maria;Garrido,Carlos J.;Alberto Padron-Navarta,Jose;Mellini,Marcello"	"Breakdown mechanisms of titanclinohumite in antigorite serpentinite (Cerro del Almirez massif, S. Spain): A petrological and TEM study"	2009
"Lopez,Gabriel;Javier Batlles,Francisco"	"Estimating solar radiation from MODIS data"	2014
"Lopez,Gabriel;Javier Batlles,Francisco;Rossi,Fillipo"	"Deriving solar radiation in a mountain area from MODIS information"	2014
"Lopez-Olvera,Jorge R.;Serrano,Emmanuel;Armenteros,Anna;Perez,Jesus M.;Fandos,Paulino;Carvalho,Joao;Velarde,Roser;Cano-Manuel,Francisco J.;Raez,Arian;Espinosa,Jose;Soriguer,Ramon C.;Granados,Jose E."	"Sex-biased severity of sarcoptic mange at the same biological cost in a sexually dimorphic ungulate"	2015
"Lopez-Rodriguez,M. J.;de Figueroa,J. M. Tierno;Alba-Tercedor,J."	"Life history and larval feeding of some species of Ephemeroptera and Plecoptera (Insecta) in the Sierra Nevada (Southern Iberian Peninsula)"	2008
"Lorite,Juan;Gomez,Francisco;Francisco Mota,Juan;Valle,Francisco"	"Orophilous plant communities of Baetic range in Andalusia (south-eastern Spain): priority altitudinal-islands for conservation"	2007
"Lorite,Juan;Molina-Morales,Mercedes;Maria Canadas,Eva;Ballesteros,Miguel;Penas,Julio"	"Evaluating a vegetation-recovery plan in Mediterranean alpine ski slopes: A chronosequence-based study in Sierra Nevada (SE Spain)"	2010
"Loureiro,Joao;Castro,Mariana;de Oliveira,Jose Cerca;Mota,Lucie;Torices,Ruben"	"Genome size variation and polyploidy incidence in the alpine flora from Spain"	2013
"Lubick,Naomi"	"Emergency medicine for frogs"	2010
"Magdaleno,F.;Blanco-Garrido,F.;Bonada,N.;Herrera-Grao,T."	"How are riparian plants distributed along the riverbank topographic gradient in Mediterranean rivers? Application to minimally altered river stretches in Southern Spain"	2014
"Maiorano,Sarah Carmen;Borrelli,Luigi;Moraci,Nicola;Gulla,Giovanni"	"Numerical Modelling to Calibrate the Geotechnical Model of a Deep-Seated Landslide in Weathered Crystalline Rocks: Acri (Calabria, Italy)"	2015
"Maranon-Jimenez,S.;Castro,J.;Kowalski,A. S.;Serrano-Ortiz,P.;Reverter,B. R.;Sanchez-Canete,E. P.;Zamora,R."	"Post-fire soil respiration in relation to burnt wood management in a Mediterranean mountain ecosystem"	2011
"Maranon-Jimenez,Sara;Castro,Jorge;Ignacio Querejeta,Jose;Fernandez-Ondono,Emilia;Allen,Craig D."	"Post-fire wood management alters water stress, growth, and performance of pine regeneration in a Mediterranean ecosystem"	2013
"Maria Conde-Porcuna,Jose;Ramos-Rodriguez,Eloisa;Perez-Martinez,Carmen"	"In situ production of empty ephippia and resting eggs by an obligate parthenogenetic Daphnia population"	2014
"Marques,Susete;Garcia-Gonzalo,Jordi;Borges,Jose G.;Botequim,Brigite;Manuela Oliveira,M.;Tome,Jose;Tome,Margarida"	"Developing Post-Fire Eucalyptus globulus Stand Damage and Tree Mortality Models for Enhanced Forest Planning in Portugal"	2011
"Marquez,F. J."	"Rickettsiae in ticks from wild ungulates of Sierra Nevada and Donana national parks (Spain)"	2009
"Martin,Rocio;Prieto,Carlos E."	"A new orophilous species of the genus Dasylobus (Opiliones: Phalangiidae) from Sierra Nevada, Spain"	2010
"Martinez-Martinez,J. M.;Torres-Ruiz,J.;Pesquera,A.;Gil-Crespo,P. P."	"Geological relationships and U-Pb zircon and Ar-40/Ar-39 tourmaline geochronology of gneisses and tourmalinites from the Nevado-Filabride complex (western Sierra Nevada, Spain): Tectonic implications"	2010
"Martin-Garcia,J. M.;Marquez,R.;Delgado,G.;Sanchez-Maranon,M.;Delgado,R."	"Relationships between quartz weathering and soil type (Entisol, Inceptisol and Alfisol) in Sierra Nevada (southeast Spain)"	2015
"Martin-Ruiz,Susana;Aceituno,Francisco J.;Gutierrez Soto,Juan"	"Setting up the T35 Telescope at Sierra Nevada Observatory for Detecting Variable Stars in Open Clusters"	2012
"Martin-Vivaldi,Manuel;Jose Soler,Juan;Moller,Anders Pape;Perez-Contreras,Tomas;Soler,Manuel"	"The importance of nest-site and habitat in egg recognition ability of potential hosts of the Common Cuckoo Cuculus canorus"	2013
"Matias,Luis;Mendoza,Irene;Zamora,Regino"	"Consistent pattern of habitat and species selection by post-dispersal seed predators in a Mediterranean mosaic landscape"	2009
"Matias,Luis;Zamora,Regino;Mendoza,Irene;Hodar,Jose A."	"Seed Dispersal Patterns by Large Frugivorous Mammals in a Degraded Mosaic Landscape"	2010
"Mayoral,Jaime G.;Barranco,Pablo"	"A new genus and species of larval mite (Acari: Prostigmata: Microtrombidiidae) parasitising Orthoptera (Tettigoniidae) from the Sierra Nevada, Spain"	2012
"Mendoza,Irene;Gomez-Aparicio,Lorena;Zamora,Regino;Matias,Luis"	"Recruitment limitation of forest communities in a degraded Mediterranean landscape"	2009
"Mendoza,Irene;Zamora,Regino;Castro,Jorge"	"A seeding experiment for testing tree-community recruitment under variable environments: Implications for forest regeneration and conservation in Mediterranean habitats"	2009
"Menendez,Rosa;Gonzalez-Megias,Adela;Jay-Robert,Pierre;Marquez-Ferrando,Rocio"	"Climate change and elevational range shifts: evidence from dung beetles in two European mountain ranges"	2014
"Metcalf,James R.;Fitzgerald,Paul G.;Baldwin,Suzanne L.;Munoz,Josep-Anton"	"Thermochronology of a convergent orogen: Constraints on the timing of thrust faulting and subsequent exhumation of the Maladeta Pluton in the Central Pyrenean Axial Zone"	2009
"Miguel Barea-Azcon,Jose;Benito,Blas M.;Olivares,Francisco J.;Ruiz,Helena;Martin,Javier;Garcia,Antonio L.;Lopez,Rogelio"	"Distribution and conservation of the relict interaction between the butterfly Agriades zullichi and its larval foodplant (Androsace vitaliana nevadensis)"	2014
"Miguel Medina-Cazorla,Jose;Gil de Carrasco,Carlos;Encarnacion Merlo,Maria;Martinez-Hernandez,Fabian;Antonio Garrido-Becerra,Juan;Salmeron,Esteban;Jesus Mendoza,Antonio;Javier Perez-Garcia,Francisco;Francisco Mota,Juan"	"The dolomite shrublands of the Convolvuletalia boissieri order and their preservation by means of the Habitats Directive"	2010
"Mira,Oscar;Martinez,Juan G.;Dawson,Deborah A.;Tinaut,Alberto;Sanchez-Prieto,Cristina"	"Twenty new microsatellite loci for population structure and parentage studies of Parnassius apollo nevadensis (Lepidoptera; Papilionidae)"	2014
"Mladenov,N.;Alados-Arboledas,L.;Olmo,F. J.;Lyamani,H.;Delgado,A.;Molina,A.;Reche,I."	"Applications of optical spectroscopy and stable isotope analyses to organic aerosol source discrimination in an urban area"	2011
"Mladenov,N.;Lopez-Ramos,J.;McKnight,D. M.;Reche,I."	"Alpine lake optical properties as sentinels of dust deposition and global change"	2009
"Mladenov,Natalie;Pulido-Villena,Elvira;Morales-Baquero,Rafael;Ortega-Retuerta,Eva;Sommaruga,Ruben;Reche,Isabel"	"Spatiotemporal drivers of dissolved organic matter in high alpine lakes: Role of Saharan dust inputs and bacterial activity"	2008
"Molero Mesa,Joaquin;Fernandez Calzado,Ma Rosa"	"Evolution of the high mountain flora of Sierra Nevada (1837-2009)"	2010
"Monforte,Laura;Nunez-Olivera,Encarnacion;Martinez-Abaigar,Javier"	"UV radiation biomonitoring using cell compartmentation of UV-absorbing compounds in herbarium samples of a liverwort"	2015
"Moreno,Javier;Palomo,Ignacio;Escalera,Javier;Martin-Lopez,Berta;Montes,Carlos"	"Incorporating ecosystem services into ecosystem-based management to deal with complexity: a participative mental model approach"	2014
"Mueller,B."	"Idaea gelbrechti Hausmann, 2003 new for Spain and Europe (Lepidoptera: Geometridae)"	2010
"Nassl,Michael;Loeffler,Joerg"	"Ecosystem services in coupled social-ecological systems: Closing the cycle of service provision and societal feedback"	2015
"Navarro,Rafael;Pereira,Dolores;Rodriguez-Navarro,Carlos;Sebastian-Pardo,Eduardo"	"The Sierra Nevada serpentinites: the serpentinites most used in Spanish heritage buildings"	2015
"Navarro,Rafael;Sanchez-Valverde,Josefina;Manuel Baltuille,Jose"	"The Natural Stone in the Historic Buildings of the City of Granada (Southern Spain). Features as a Possible Candidate for the Designation of \"Global Heritage Stone Province\""	2015
"Negro,F.;de Sigoyer,J.;Goffe,B.;Saddiqi,O.;Villa,I. M."	"Tectonic evolution of the Betic-Rif arc: New constraints from (40)Ar/(39)Ar dating on white micas in the Temsamane units (External Rif, northern Morocco)"	2008
"Notario del Pino,Jesus S.;Ruiz-Gallardo,Jose-Reyes"	"Modelling post-fire soil erosion hazard using ordinal logistic regression: A case study in South-eastern Spain"	2015
"Oliva,M.;Gomez Ortiz,A."	"Holocene slope dynamics in Sierra Nevada (south Spain). Sedimentological analysis of solifluction landforms and lake deposits"	2011
"Oliva,Marc;Gomez Ortiz,Antonio;Salvador Franch,Ferran;Salva Catarineu,Montserrat"	"Present-Day Solifluction Processes in the Semi-arid Range of Sierra Nevada (Spain)"	2014
"Oliva,Marc;Gomez Ortiz,Antonio;Salvador,Ferran;Salva,Montserrat;Pereira,Paulo;Geraldes,Miguel"	"Long-term soil temperature dynamics in the Sierra Nevada, Spain"	2014
"Oliva,Marc;Gomez-Ortiz,A."	"Late-Holocene environmental dynamics and climate variability in a Mediterranean high mountain environment (Sierra Nevada, Spain) inferred from lake sediments and historical sources"	2012
"Oliva,Marc;Ortiz,Antonio Gomez;Palacios,David;Salvador-Franch,Ferran;Salva-Catarineu,Montserrat"	"Environmental evolution in Sierra Nevada (South Spain) since the Last Glaciation, based on multi-proxy records"	2014
"Oliva,Marc;Schulte,Lothar;Gomez Ortiz,Antonio"	"The role of aridification in constraining the elevation range of Holocene solifluction processes and associated landforms in the periglacial belt of the Sierra Nevada (southern Spain)"	2011
"Oliva,Marc;Schulte,Lothar;Gomez Ortiz,Antonio"	"Morphometry and Late Holocene Activity of Solifluction Landforms in the Sierra Nevada, Southern Spain"	2009
"Olive,Marc;Gomez Ortiz,Antonio;Palacios Estremera,David;Salvador Franch,Ferran;Salva Catarineu,Monserrat"	"The Quaternary in the Massif of the Sierra Nevada. Evolution Paleoenvironmental and Landscape from the Interpretation of Natural Logs and Documents of Time"	2014
"Ortigosa,Angel L.;Gomez,Jose M."	"Differences in the diversity and composition of the pollinator assemblage of two co-flowering congeneric alpine wallflowers, Erysimum nevadense and E. baeticum"	2010
"Oster,Jessica L.;Montanez,Isabel P.;Mertz-Kraus,Regina;Sharp,Warren D.;Stock,Greg M.;Spero,Howard J.;Tinsley,John;Zachos,James C."	"Millennial-scale variations in western Sierra Nevada precipitation during the last glacial cycle MIS 4/3 transition"	2014
"Padilla,Francisco M.;Vidal,Beatriz;Sanchez,Joaquin;Pugnaire,Francisco I."	"Land-use changes and carbon sequestration through the twentieth century in a Mediterranean mountain ecosystem: Implications for land management"	2010
"Palade,Bogdan;Serrano,Milagros"	"Long-term high-frequency validation of MODIS LST products in a Mediterranean mountain environment"	2014
"Palenzuela,J. A.;Marsella,M.;Nardinocchi,C.;Perez,J. L.;Fernandez,T.;Chacon,J.;Irigaray,C."	"Landslide detection and inventory by integrating LiDAR data in a GIS environment"	2015
"Palenzuela,Javier;Azcon-Aguilar,Concepcion;Barea,Jose-Miguel;da Silva,Gladstone Alves;Oehl,Fritz"	"Acaulospora viridis, a new species in the Glomeromycetes from two mountain ranges in Andalucia (Spain)"	2014
"Palenzuela,Javier;Azcon-Aguilar,Concepcion;Barea,Jose-Miguel;da Silva,Gladstone Alves;Oehl,Fritz"	"Acaulospora pustulata and Acaulospora tortuosa, two new species in the Glomeromycota from Sierra Nevada National Park (southern Spain)"	2013
"Palenzuela,Javier;Miguel Barea,Jose;Ferrol,Nuria;Azcon-Aguilar,Concepcion;Oehl,Fritz"	"Entrophospora nevadensis, a new arbuscular mycorrhizal fungus from Sierra Nevada National Park (southeastern Spain)"	2010
"Palenzuelal,Javier;Azcon-Aguilar,Concepcion;Berea,Jose-Miguel;da Silva,Gladstone Alves;Oehl,Fritz"	"Acaulospora baetica, a new arbuscular mycorrhizal fungal species from two mountain ranges in Andalucia (Spain)"	2015
"Palomo,Ignacio;Martin-Lopez,Berta;Alcorlo,Paloma;Montes,Carlos"	"Limitations of Protected Areas Zoning in Mediterranean Cultural Landscapes Under the Ecosystem Services Approach"	2014
"Pascual,Emilio;Donaire,Teodosio;Pin,Christian"	"The significance of microgranular enclaves in assessing the magmatic evolution of a high-level composite batholith: A case on the Los Pedroches Batholith, Iberian Massif, Spain"	2008
"Pascual,Javier;Blanco,Silvia;Garcia-Lopez,Marina;Garcia-Salamanca,Adela;Bursakov,Sergey A.;Genilloud,Olga;Bills,Gerald F.;Ramos,Juan L.;van Dillewijn,Pieter"	"Assessing Bacterial Diversity in the Rhizosphere of Thymus zygis Growing in the Sierra Nevada National Park (Spain) through Culture-Dependent and Independent Approaches"	2016
"Pascual,Javier;Garcia-Lopez,Marina;Carmona,Cristina;Sousa,Thiciana da S.;de Pedro,Nuria;Cautain,Bastien;Martin,Jesus;Vicente,Francisca;Reyes,Fernando;Bills,Gerald F.;Genilloud,Olga"	"Pseudomonas soli sp nov., a novel producer of xantholysin congeners"	2014
"Passerin D'Entreves,Pietro;Roggero,Angela"	"The first case of gynandromorphism in Enolmis (Lepidoptera: Gelechioidea: Scythrididae)"	2013
"Pedrera,Antonio;Galindo-Zaldivar,Jesus;Lamas,Francisco;Ruiz-Constan,Ana"	"Evolution of near-surface ramp-flat-ramp normal faults and implication during intramontane basin formation in the eastern Betic Cordillera (the Huercal-Overa Basin, SE Spain)"	2012
"Pedrera,Antonio;Vicente Perez-Pena,Jose;Galindo-Zaldivar,Jesus;Miguel Azanon,Jose;Azor,Antonio"	"Testing the sensitivity of geomorphic indices in areas of low-rate active folding (eastern Betic Cordillera, Spain)"	2009
"Penas,Julio;Lorite,Juan;Alba-Sanchez,Francisca;Angelica Taisma,Maria"	"Self-incompatibility, floral parameters, and pollen characterization in the narrow endemic and threatened species Artemisia granatensis (Asteraceae)"	2011
"Pepin,E.;Carretier,S.;Herail,G."	"Erosion dynamics modelling in a coupled catchment-fan system with constant external forcing"	2010
"Peredo,Elena L.;Angeles Revilla,M.;Jimenez-Alfaro,Borja;Bueno,Alvaro;Cires,Eduardo;Fernandez Prieto,J. Antonio;Abbott,Richard J."	"APPLICATIONS OF MOLECULAR MARKERS PRIOR CONSERVATION ACTIONS ON THE SPANISH ENDEMIC Senecio boissieri"	2009
"Peredo,Elena L.;Angeles Revilla,M.;Jimenez-Alfaro,Borja;Bueno,Alvaro;Fernandez Prieto,J. Antonio;Abbott,Richard J."	"Historical biogeography of a disjunctly distributed, Spanish alpine plant, Senecio boissieri (Asteraceae)"	2009
"Perez,Jesus M.;Granados,Jose E.;Sarasa,Mathieu;Serrano,Emmanuel"	"Usefulness of estimated surface area of damaged skin as a proxy of mite load in the monitoring of sarcoptic mange in free-ranging populations of Iberian wild goat, Capra pyrenaica"	2011
"Perez,Jesus M.;Serrano,Emmanuel;Soriguer,Ramon C.;Gonzalez,Francisco J.;Sarasa,Mathieu;Granados,Jose E.;Cano-Manuel,Francisco J.;Cuenca,Rafaela;Fandos,Paulino"	"Distinguishing Disease Effects from Environmental Effects in a Mountain Ungulate: Seasonal Variation in Body Weight, Hematology, and Serum Chemistry among Iberian Ibex (Capra Pyrenaica) Affected by Sarcoptic Mange"	2015
"Perez-Garcia,F. J.;Martinez-Hernandez,F.;Medina-Cazorla,J. M.;Mendoza-Fernandez,A. J.;Garrido-Becerra,J. A.;Salmeron-Sanchez,E.;Mota,J. F."	"Syntaxa-area relationships, lessons from the vegetation of the Betic high mountain ranges (southern Spain)"	2014
"Perez-Garcia,Francisco Javier;Cueto,Miguel;Penas,Julio;Martinez-Hernandez,Fabian;Medina-Cazorla,Jose Miguel;Garrido-Becerra,Juan Antonio;Mota,Juan Francisco"	"Selection of an endemic flora reserve network and its biogeographical significance in the Baetic ranges (Southern Spain)"	2007
"Perez-Luque,A. J.;Perez-Perez,R.;Bonet-Garcia,F. J.;Magana,P. J."	"An ontological system based on MODIS images to assess ecosystem functioning of Natura 2000 habitats: A case study for Quercus pyrenaica forests"	2015
"Perez-Martinez,C.;Barea-Arco,J.;Conde-Porcuna,J. M.;Morales-Baquero,R."	"Reproduction strategies of Daphnia pulicaria population in a high mountain lake of Southern Spain"	2007
"Perez-Martinez,Carmen;Jimenez,Laura;Moreno,Emilio;Conde-Porcuna,Jose M."	"Emergence pattern and hatching cues of Daphnia pulicaria (Crustacea, Cladocera) in an alpine lake"	2013
"Perez-Palazon,M. J.;Pimentel,R.;Herrero,J.;Aguilar,C.;Perales,J. M.;Polo,M. J."	"Extreme values of snow-related variables in Mediterranean regions: trends and long-term forecasting in Sierra Nevada (Spain)"	2015
"Perez-Pena,J. V.;Azanon,J. M.;Azor,A."	"CalHypso: An ArcGIS extension to calculate hypsometric curves and their statistical moments. Applications to drainage basin analysis in SE Spain"	2009
"Perini,Giulia;Cesare,Bernardo;Gomez-Pugnaire,Maria Teresa;Ghezzi,Lorenzo;Tommasini,Simone"	"Armouring effect on Sr-Nd isotopes during disequilibrium crustal melting: the case study of frozen migmatites from El Hoyazo and Mazarron, SE Spain"	2009
"Pimentel,Rafael;Herrero,Javier;Jose Polo,Maria"	"Estimating snow albedo patterns in a Mediterranean site from Landsat TM and ETM plus images"	2013
"Pimentel,Rafael;Herrero,Javier;Jose Polo,Maria"	"Terrestrial photography as an alternative to satellite images to study snow cover evolution at hillslope scale"	2012
"Pimentel,Rafael;Herrero,Javier;Polo,Maria Jose"	"Snow evolution in a semi-arid mountainous area combining snow modelling and Landsat spectral mixture analysis"	2015
"Pimentel,Rafael;Herrero,Javier;Zeng,Yijian;Su,Zhongbo;Polo,Maria J."	"Study of Snow Dynamics at Subgrid Scale in Semiarid Environments Combining Terrestrial Photography and Data Assimilation Techniques"	2015
"Pisa,Sergio;Werner,Olaf;Vanderpoorten,Alain;Magdy,Mahmoud;Ros,Rosa M."	"Elevational Patterns of Genetic Variation in the Cosmopolitan Moss Bryum Argenteum (Bryaceae)"	2013
"Pozo,Jesus;Casas,Jesus;Menendez,Margarita;Molla,Salvador;Arostegui,Inmaculada;Basaguren,Ana;Casado,Carmen;Descals,Enrique;Garcia-Aviles,Javier;Gonzalez,Jose M.;Larranaga,Aitor;Lopez,Enrique;Lusi,Mirian;Moya,Oscar;Perez,Javier;Riera,Tecla;Roblas,Neftali;Jacoba Salinas,M."	"Leaf-litter decomposition in headwater streams: a comparison of the process among four climatic regions"	2011
"Prados Velasco,Ma Jose"	"Naturbanization and Urban Patterns in National Parks in Andalusia"	2012
"Puerta-Pinero,Carolina"	"Changes in riparian forest composition along a sedimentation rate gradient"	2010
"Puerta-Pinero,Carolina;Gomez,Jose Maria;Schupp,Eugene W."	"Spatial patterns of acorn dispersal by rodents: do acorn crop size and ungulate presence matter?"	2010
"Puglisi,Marta;Kuerschner,Harald;Privitera,Maria"	"The Schistidio atrofusci-Grimmietum pulvinatae, a new association of the class Grimmietea anodontis on the Mediterranean mountains"	2015
"Pulido-Villena,Elvira;Reche,Isabel;Morales-Baquero,Rafael"	"Evidence of an atmospheric forcing on bacterioplankton and phytoplankton dynamics in a high mountain lake"	2008
"Quesada-Rubio,Jose-Manuel;Huete-Morales,Maria-Dolores;Del-Moral-Avila,Maria-Jose;Navarrete-Alvarez,Esteban;Rosales-Moreno,Maria-Jesus"	"Impact of Environmental and Human Factors on Rural Fire Occurrence"	2011
"Raez-Bravo,Arian;Enrique Granados,Jose;Joaquin Ceron,Jose;Javier Cano-Manuel,Francisco;Fandos,Paulino;Maria Perez,Jesus;Espinosa,Jose;Casimiro Soriguer,Ramon;Ramon Lopez-Olvera,Jorge"	"Acute phase proteins increase with sarcoptic mange status and severity in Iberian ibex (Capra pyrenaica, Schinz 1838)"	2015
"Rams,Susana;Werner,Olaf;Ros,Rosa M."	"Updated checklist of the Bryophytes from the Sierra Nevada Mountains (S of Spain)"	2014
"Reboleiro-Rivas,P.;Juarez-Jimenez,B.;Martinez-Toledo,M., V.;Rodelas,B.;Andrade,L.;Gonzalez-Lopez,J.;Fenice,M."	"Bacterial Communities' Structure in a High mountain lake during the ice-free season: cultural and PCR-TGGE investigations"	2013
"Reguera,Senda;Zamora-Camacho,Francisco J.;Moreno-Rueda,Gregorio"	"The lizard Psammodromus algirus (Squamata: Lacertidae) is darker at high altitudes"	2014
"Reguera,Senda;Zamora-Camacho,Francisco J.;Trenzado,Cristina E.;Sanz,Ana;Moreno-Rueda,Gregorio"	"Oxidative stress decreases with elevation in the lizard Psammodromus algirus"	2014
"Rodriguez,Ferran A.;Iglesias,Xavier;Feriche,Belen;Calderon,Carmen;Abalos,Xavier;Vazquez,Jairo;Barrero,Anna;Rodriguez,Lara;Hynynen,Esa;Levine,Benjamin D."	"Effects of Altitude Training on Heart Rate Variability in Orthostatic Test in Elite Swimmers"	2012
"Rodriguez-Fernandez,Jose;Azor,Antonio;Miguel Azanon,Jose"	"The Betic intramontane basins (SE spain): stratigraphy, subsidence, and tectonic history"	2012
"Rodriguez-Peces,M. J.;Garcia-Mayordomo,J.;Azanon,J. M.;Jabaloy,A."	"GIS application for regional assessment of seismically induced slope failures in the Sierra Nevada Range, South Spain, along the Padul Fault"	2014
"Rolland,A.;Lopez de Coca,P.;Costa,V.;Rodriguez,E.;Olivares,I."	"Stromgren photometry of the delta Scuti star 67 UMa"	2008
"Sainz-Bariain,Marta;Zamora-Munoz,Carmen"	"The larva and life history of Stenophylax nycterobius (McLachlan, 1875) (Trichoptera: Limnephilidae) in high mountain streams (Sierra Nevada, Spain) and key to the Iberian larvae of the genus"	2012
"Sanchez-Castillo,Pedro M.;Linares-Cuesta,J. Eduardo;Fernandez-Moreno,D."	"Changes in epilithic diatom assemblages in a Mediterranean high mountain lake (Laguna de La Caldera, Sierra Nevada, Spain) after a period of drought"	2008
"Sanchez-Maranon,M.;Martin-Garcia,J. M.;Delgado,R."	"Effects of the fabric on the relationship between aggregate stability and color in a Regosol-Umbrisol soilscape"	2011
"Santamaria,Silvia;Galeano,Javier;Manuel Pastor,Juan;Mendez,Marcos"	"Robustness of alpine pollination networks: effects of network structure and consequences for endemic plants"	2014
"Sanz de Galdeano,C.;Garcia-Tortosa,F. J.;Pelaez,J. A.;Alfaro,P.;Azanon,J. M.;Galindo-Zaldivar,J.;Lopez Casado,C.;Lopez Garrido,A. C.;Rodriguez-Fernandez,J.;Ruano,P."	"Main active faults in the Granada and Guadix-Baza Basins (Betic Cordillera)"	2012
"Sanz,Ana;Trenzado,Cristina E.;Lopez-Rodriguez,Manuel J.;Furne,Miriam;Manuel Tierno de Figueroa,J."	"Study of Antioxidant Defense in Four Species of Perloidea (Insecta, Plecoptera)"	2010
"Sarasa,M.;Serrano,E.;Perez,J. M.;Soriguer,R. C.;Gonzalez,G.;Joachim,J.;Fandos,P.;Granados,J. -E"	"Effects of season, age and body condition on allocation to testes mass in Iberian ibex"	2010
"Sarasa,M.;Soriguer,R. C.;Granados,J. -E;Casajus,N.;Perez,J. M."	"Mismeasure of secondary sexual traits: an example with horn growth in the Iberian ibex"	2012
"Sarasa,Mathieu;Perez,Jesus M.;Granados,Jose-Enrique;Soriguer,Ramon C."	"Is nursing a kid detrimental to nonimmunological compatibility to contact-transmitted foreign bodies in female Iberian ibex (Capra pyrenaica)?"	2012
"Sarasa,Mathieu;Serrano,Emmanuel;Gonzalez,Georges;Granados,Jose-Enrique;Soriguer,Ramon C.;Perez,Jesus M.;Joachim,Jean"	"Pseudoectoparasites: a new tool for exploring the relationship between host behaviour and ectoparasites"	2009
"Sarasa,Mathieu;Serrano,Emmanuel;Soriguer,Ramon C.;Granados,Jose-Enrique;Fandos,Paulino;Gonzalez,Georges;Joachim,Jean;Perez,Jesus M."	"Negative effect of the arthropod parasite, Sarcoptes scabiei, on testes mass in Iberian ibex, Capra pyrenaica"	2011
"Sarp,Gulcan"	"Tectonic controls of the North Anatolian Fault System (NAFS) on the geomorphic evolution of the alluvial fans and fan catchments in Erzincan pull-apart basin; Turkey"	2015
"Savage,Wesley K.;Fremier,Alexander K.;Shaffer,H. Bradley"	"Landscape genetics of alpine Sierra Nevada salamanders reveal extreme population subdivision in space and time"	2010
"Schank,C. M. M.;Paszkowski,C. A.;Tonn,W. M.;Scrimgeour,G. J."	"Stocked trout do not significantly affect wood frog populations in boreal foothills lakes"	2011
"Schoeb,Christian;Prieto,Ivan;Armas,Cristina;Pugnaire,Francisco I."	"Consequences of facilitation: one plant's benefit is another plant's cost"	2014
"Schroeder,Christoph;Bonet Garcia,Francisco Javier;Buck,Oliver;Corbane,Christina;Deshayes,Michel;Foerster,Michael;Garcia Millan,Virginia;Gil Jimenez,Yolanda;Lang,Stefan;Ramos Losada,Blanca;Simon Colina,Alejandro;Vanden Borre,Jeroen"	"Validation of Habitat Assessment Services in Natura 2000 Sites: Streamlining the Role of Stakeholders from User Needs to Conservation Status Evaluation"	2013
"Serrano,Emmanuel;Enrique Granados,Jose;Sarasa,Mathieu;Jose Gonzalez,Francisco;Fandos,Paulino;Soriguer,Ramon C.;Perez,Jesus M."	"The effects of winter severity and population density on body stores in the Iberian wild goat (Capra pyrenaica) in a highly seasonal mountain environment"	2011
"Serrano,Emmanuel;Gonzalez,Francisco J.;Granados,Jose E.;Moco,Gisela;Fandos,Paulino;Soriguer,Ramon C.;Perez,Jesus M."	"The use of Total Serum Proteins and Triglycerides for Monitoring Body Condition in the Iberian Wild Goat (Capra Pyrenaica)"	2008
"Smith,Michael;Koren,Victor;Zhang,Ziya;Moreda,Fekadu;Cui,Zhengtao;Cosgrove,Brian;Mizukami,Naoki;Kitzmiller,David;Ding,Feng;Reed,Seann;Anderson,Eric;Schaake,John;Zhang,Yu;Andreassian,Vazken;Perrin,Charles;Coron,Laurent;Valery,Audrey;Khakbaz,Behnaz;Sorooshian,Soroosh;Behrangi,Ali;Imam,Bisher;Hsu,Kuo-Lin;Todini,Ezio;Coccia,Gabriele;Mazzetti,Cinzia;Andres,Enrique Ortiz;Frances,Felix;Orozco,Ismael;Hartman,Robert;Henkel,Arthur;Fickenscher,Peter;Staggs,Scott"	"The distributed model intercomparison project - Phase 2: Experiment design and summary results of the western basin experiments"	2013
"Sousa,Joaquim J.;Ruiz,Antonio M.;Hooper,Andrew J.;Hanssen,Ramon F.;Perski,Zbigniew;Bastos,Luisa C.;Gil,Antonio J.;Galindo-Zaldivar,Jesus;Sanz de Galdeano,Carlos;Alfaro,Pedro;Selmira Garrido,Ma;Armenteros,Juan A.;Gimenez,Elena;Aviles,Manuel"	"Multi-temporal InSAR for deformation monitoring of the Granada and Padul faults and the surrounding area (Betic Cordillera, southern Spain)"	2014
"Souza,M. S.;Modenutti,B. E.;Carrillo,P.;Villar-Argaiz,M.;Medina-Sanchez,J. M.;Bullejos,F.;Balseiro,E. G."	"Stoichiometric dietary constraints influence the response of copepods to ultraviolet radiation-induced oxidative stress"	2010
"Sparling,Donald W.;Bickham,John;Cowman,Deborah;Fellers,Gary M.;Lacher,Thomas;Matson,Cole W.;McConnell,Laura"	"In situ effects of pesticides on amphibians in the Sierra Nevada"	2015
"Teresa Vizoso,Maria;Bruno Navarro,Francisco;Lorite,Juan"	"Thymus x pseudogranatensis (Labiatae), a new hybrid from Sierra Nevada (Spain)"	2011
"Trepet,S. A.;Eskina,T. G.;Bibina,K. V."	"Influence of environmental factors on number dynamics and spatial structure of the tur (Capra caucasica) population in the Caucasian Reserve"	2014
"Trueba,J. J. Gonzalez;Moreno,R. Martin;de Pison,E. Martinez;Serrano,E."	"'Little Ice Age' glaciation and current glaciers in the Iberian Peninsula"	2008
"Ubide,Teresa;Gale,Carlos;Larrea,Patricia;Arranz,Enrique;Lago,Marceliano;Tierz,Pablo"	"The Relevance of Crystal Transfer to Magma Mixing: a Case Study in Composite Dykes from the Central Pyrenees"	2014
"Valbuena-Carabana,Maria;Gil,Luis"	"Genetic resilience in a historically profited root sprouting oak (Quercus pyrenaica Willd.) at its southern boundary"	2013
"Valero,Pablo;Ortiz,Antonio S."	"Description and DNA barcoding of a new Iberian species of Pijnackeria (Scali, 2009) from Sierra Nevada, Spain (Phasmida: Diapheromeridae)"	2015
"Vazquez,Mercedes;Jabaloy,Antonio;Barbero,Luis;Stuart,Finly M."	"Deciphering tectonic- and erosion-driven exhumation of the Nevado-Filabride Complex (Betic Cordillera, Southern Spain) by low temperature thermochronology"	2011
"Vega,J.;Jimenez,E.;Vega,D.;Ortiz,L.;Perez,J. R."	"Pinus pinaster Ait. tree mortality following wildfire in Spain"	2011
"Verbena,J. L.;Schroeder,K. -P;Jeyakumar,S.;Wachter,A."	"Probing the Cool Outer Envelope of NGC 6826"	2013
"Verbisck-Bucker,G.;Gonzalez-Candela,M.;Galian,J.;Cubero-Pablo,M. J.;Martin-Atance,P.;Leon-Vizcaino,L."	"Epidemiology of Mycoplasma agalactiae infection in free-ranging Spanish ibex (Capra pyrenaica) in Andalusia, southern Spain"	2008
"Vicente Perez-Pena,Jose;Azor,Antonio;Miguel Azanon,Jose;Keller,Edward A."	"Active tectonics in the Sierra Nevada (Betic Cordillera, SE Spain): Insights from geomorphic indexes and drainage pattern analysis"	2010
"Viedma,Olga;Quesada,Juan;Torres,Ivan;De Santis,Angela;Moreno,Jose M."	"Fire Severity in a Large Fire in a Pinus pinaster Forest is Highly Predictable from Burning Conditions, Stand Structure, and Topography"	2015
"Villar-Argaiz,Manuel;Jose Bullejos,Francisco;Manuel Medina-Sanchez,Juan;Ramos-Rodriguez,Eloisa;Antonio Delgado-Molina,Jose;Carrillo,Presentacion"	"Disentangling food quantity and quality effects in zooplankton response to P-enrichment and UV radiation"	2012
"Villar-Argaiz,Manuel;Medina-Sanchez,Juan M.;Bullejos,Francisco J.;Delgado-Molina,Jose A.;Ruiz Perez,Olga;Navarro,Juan C.;Carrillo,Presentacion"	"UV radiation and phosphorus interact to influence the biochemical composition of phytoplankton"	2009
"Wachsmuth,Nadine B.;Kley,Marlen;Feriche,Belen;Calderon,Carmen;Iglesias,Xavier;Rodriguez,Ferran A.;Schmidt,Walter F."	"Influencing Factors On The Erythropoietic Response During Altitude Training (Altitude Project)"	2014
"Walczak,Izabela W.;Baldini,James U. L.;Baldini,Lisa M.;McDermott,Frank;Marsden,Stuart;Standish,Christopher D.;Richards,David A.;Andreo,Bartolome;Slater,Jonathan"	"Reconstructing high-resolution climate using CT scanning of unsectioned stalagmites: A case study identifying the mid-Holocene onset of the Mediterranean climate in southern Iberia"	2015
"Werner,Olaf;Rams,Susana;Kucera,Jan;Larrain,Juan;Afonina,Olga M.;Pisa,Sergio;Maria Ros,Rosa"	"New data on the moss genus Hymenoloma (Bryophyta), with special reference to H. mulahaceni"	2013
"White,Angela M.;Zipkin,Elise F.;Manley,Patricia N.;Schlesinger,Matthew D."	"Simulating avian species and foraging group responses to fuel reduction treatments in coniferous forests"	2013
"Woodward,Casandra;Johnson,Dale W.;Meadows,Matthew W.;Miller,Watkins W.;Hynes,Meagan M.;Robertson,Carrina M."	"Nutrient Hot Spots in a Sierra Nevada Forest Soil: Temporal Characteristics and Relations to Microbial Communities"	2013
"Xing,Fei;Kettner,Albert J.;Ashton,Andrew;Giosan,Liviu;Ibanez,Caries;Kaplan,Jed O."	"Fluvial response to climate variations and anthropogenic perturbations for the Ebro River, Spain in the last 4000 years"	2014
"Zamora,Regino;Antonio Hodar,Jose;Matias,Luis;Mendoza,Irene"	"Positive adjacency effects mediated by seed disperser birds in pine plantations"	2010
"Zamora,Regino;Miguel Barea-Azcon,Jose"	"Long-Term Changes in Mountain Passerine Bird Communities in the Sierra Nevada (Southern Spain): a 30-Year Case Study"	2015
"Zamora-Camacho,F. J.;Reguera,S.;Moreno-Rueda,G."	"Does tail autotomy affect thermoregulation in an accurately thermoregulating lizard? Lessons from a 2200-m elevational gradient"	2015
"Zamora-Camacho,F. J.;Reguera,S.;Moreno-Rueda,G."	"Bergmann's Rule rules body size in an ectotherm: heat conservation in a lizard along a 2200-metre elevational gradient"	2014
"Zamora-Camacho,F. J.;Reguera,S.;Moreno-Rueda,G.;Pleguezuelos,J. M."	"Patterns of seasonal activity in a Mediterranean lizard along a 2200 m altitudinal gradient"	2013
"Zamora-Camacho,Francisco J.;Reguera,Senda;Virtudes Rubino-Hispan,M.;Moreno-Rueda,Gregorio"	"Effects of Limb Length, Body Mass, Gender, Gravidity, and Elevation on Escape Speed in the Lizard Psammodromus algirus"	2014
"Zeller-Lukashort,H. C.;Werno,A.;Kurz,M. A."	"A new species of Micropterix Hubner, [1825] from southern Spain (Lepidoptera: Micropterigidae)"	2013
"Zielinski,William J.;Thompson,Craig M.;Purcell,Kathryn L.;Garner,James D."	"An assessment of fisher (Pekania pennanti) tolerance to forest management intensity on the landscape"	2013
"Zuazo,V. H. Duran;Pleguezuelo,C. R. Rodriguez;Martinez,J. R. Francia;Rodiguez,B. Carceles;Raya,A. Martinez;Galindo,P. Perez"	"Harvest intensity of aromatic shrubs vs. soil erosion: An equilibrium for sustainable agriculture (SE Spain)"	2008
"Zuazo,Victor Hugo Duran;Pleguezuelo,Carmen Rocio Rodriguez;Martinez,Jose Ramon Francia;Raya,Armando Martinez;Panadero,Lorenzo Arroyo;Rodriguez,Belen Carceles;Moll,Maria Concepcion Navarro"	"Benefits of plant strips for sustainable mountain agriculture"	2008
"[Anonymous]"	"XXVII International Meeting on Fundamental Physics - Sierra Nevada (Granada), Spain - February 1-5, 1999 - Preface"	1999
"Acevedo,Pelayo;Cassinello,Jorge;Hortal,Joaquin;Gortazar,Christian"	"Invasive exotic aoudad (Ammotragus lervia) as a major threat to native Iberian ibex (Capra pyrenaica): a habitat suitability model approach"	2007
"Acosta,M. J.;Marchal,J. A.;Martinez,S.;Puerma,E.;Bullejos,M.;la de Guardia,R. Diaz;Sanchez,A."	"Characterization of the satellite DNA Msat-160 from the species Chionomys nivalis (Rodentia, Arvicolinae)"	2007
"Adams,RP;Pandey,RN"	"Analysis of Juniperus communis and its varieties based on DNA fingerprinting"	2003
"ALADOS,CL;ESCOS,J."	"Parturition Dates and Mother-Kid Behavior in Spanish Ibex (Capra-Pyrenaica) in Spain"	1988
"Alados-Arboledas,Lucas;Guerrero Rascado,Juan Luis;Lyamani,Hassan;Navas-Guzman,Franscisco;Olmo Reyes,Francisco Jose"	"Characterization of the atmospheric aerosol by combination of LIDAR and sun-photometry"	2007
"Alba-Tercedor,J.;Derka,T."	"Torleya nazarita sp n., a new species from Southern Spain (Ephemeroptera : Ephemerellidae)"	2003
"ALBATERCEDOR,J.;SOWA,R."	"New Representatives of the Rhithrogena-Diaphana-Group from Continental Europe, with a Redescription of Rhithrogena-Diaphana Navas, 1917 (Ephemeroptera, Heptageniidae)"	1987
"ALBATERCEDOR,J.;STUDEMANN,D."	"Upon the Identity of Drunella-Andaluciaca Kazanci, 1990 (Ephemeroptera, Ephemerellidae)"	1992
"Almazan-Vazquez,Emilio;Buitron-Sanchez,Blanca E.;Vachard,Daniel;Mendoza-Madera,Cynthia;Gomez-Espinosa,Catalina"	"The late Atokan (Moscovian, Pennsylvanian) chaetetid accumulations of Sierra Agua Verde, Sonora (NW Mexico): composition, facies and palaeoenvironmental signals"	2007
"Angeler,DG;Garcia,G.;Schagerl,M."	"Heterotrophic euglenoid flagellates from the Sierra Nevada Natural Park area (Southern Spain)"	2002
"Antoci,V.;Rodler,F."	"44 Tau: a slowly rotating delta Scuti star"	2002
"Augier,R.;Jolivet,L.;Robin,C."	"Late Orogenic doming in the eastern Betic Cordilleras: Final exhumation of the Nevado-Filabride complex and its relation to basin genesis"	2005
"Azanon,J. M.;Tuccimei,P.;Azor,A.;Sanchez-Almazo,I. M.;Alonso-Zarza,A. M.;Soligo,M.;Perez-Pena,J. V."	"Calcrete features and age estimates from U/Th dating: Implications for the analysis of Quaternary erosion rates in the northern limb of the Sierra Nevada range (Betic Cordillera, southeast Spain)"	2006
"Azanon,JM;Azor,A.;Booth-Rea,G.;Torcal,F."	"Small-scale faulting, topographic steps and seismic ruptures in the Alhambra (Granada, southeast Spain)"	2004
"Azanon,JM;CrespoBlanc,A.;GarciaDuenas,V."	"Continental collision, crustal thinning and nappe forming during the pre-Miocene evolution of the Alpujarride Complex (Alboran Domain, Betics)"	1997
"Azanon,JM;Garcia-Duenas,V.;Goffe,B."	"Exhumation of high-pressure metapelites and coeval crustal extension in the Alpujarride complex (Betic Cordillera)"	1998
"Azevedo,MR;Nolan,J."	"Hercynian late-post-tectonic granitic rocks from the Fornos de Algodres area (Northern Central Portugal)"	1998
"BAARS,JWM;GREVE,A.;HEIN,H.;MORRIS,D.;PENALVER,J.;THUM,C."	"Design Parameters and Measured Performance of the Iram 30-M Millimeter Radio Telescope"	1994
"Baraza,E.;Zamora,R.;Hodar,JA"	"Conditional outcomes in plant-herbivore interactions: neighbours matter"	2006
"Barea-Arco,J.;Perez-Martinez,C.;Morales-Baquero,R."	"Evidence of a mutualistic relationship between an algal epibiont and its host, Daphnia pulicaria"	2001
"BARRANCO,P.;CABRERO,J.;CAMACHO,JPM;PASCUAL,F."	"Chromosomal Basis for a Bilateral Gynandromorph in Pycnogaster-Inermis (Rambur, 1838) (Orthoptera, Tettigoniidae)"	1995
"BEA,F.;PEREIRA,MD;CORRETGE,LG;FERSHTATER,GB"	"Differentiation of Strongly Peraluminous, Perphosphorus Granites - the Pedrobernardo Pluton, Central Spain"	1994
"Benitez,G.;Vazquez,R.;Zavala,S.;Blanco,MW;Ayala,S.;Miranda,LF;Gullen,PF"	"The physical structure of the planetary nebula NGC 6445"	2005
"Bernal,S.;Butturini,A.;Sabater,F."	"Seasonal variations of dissolved nitrogen and DOC : DON ratios in an intermittent Mediterranean stream"	2005
"Blanca,G.;Cueto,M.;Martinez-Lirola,MJ;Molero-Mesa,J."	"Threatened vascular flora of Sierra Nevada (southern Spain)"	1998
"Blanca,G.;Ruiz-Rejon,M.;Zamora,R."	"Taxonomic revision of the genus Pinguicula L-in the Iberian Peninsula"	1999
"Booth-Rea,G.;Azanon,JM;Garcia-Duenas,V.;Augier,R.;Sanchez-Gomez,M."	"A 'core-complex-like structure' formed by superimposed extension, folding and high-angle normal faulting. The Santi Petri dome (western Betics, Spain)"	2003
"Bosch,J.;Rincon,PA;Boyero,L.;Martinez-Solano,I."	"Effects of introduced salmonids on a montane population of Iberian frogs"	2006
"Botosaneanu,L.;Gonzalez,MA"	"A difficult taxonomic problem: the Micrasema (Trichoptera : Brachycentridae) of the Iberian and Pyrenean running waters"	2006
"Braga,JC;Martin,JM;Quesada,C."	"Patterns and average rates of late Neogene-Recent uplift of the Betic Cordillera, SE Spain"	2003
"Brunswig,W.;Sievers,A.;Thum,C.;Wild,W."	"Remote observing with the 30m radiotelescope"	2000
"BUCHAR,J.;THALER,K."	"On the Genus Acantholycosa in Western-Europe (Arachnida, Araneida, Lycosidae)"	1993
"CABRERO,J.;CAMACHO,JPM"	"Chiasma Distribution and Centromere Orientation in a Spontaneous Interchange in the Grasshopper Chorthippus-Vagans"	1986
"Cabrero,J.;Lopez-Leon,MD;Camacho,JPM"	"Ribosomal DNA in a supernumerary chromosome segment of the grasshopper Oedipoda fuscocincta confirms its origin by translocation"	1998
"Calle Martinez,D.;Vilchez Quero,A.;Casas Jimenez,J. J."	"Chironomids (Diptera) of the Upper Guadalquivir (Sierra de Cazorla, Southern Spain)."	1995
"Calvache,ML;Viseras,C."	"Long-term control mechanisms of stream piracy processes in southeast Spain"	1997
"Calvache,ML;Viseras,C.;Fernandez,J."	"Controls on fan development - evidence from fan morphometry and sedimentology; Sierra Nevada, SE Spain"	1997
"CALVOFLORES,GD;SANCHEZMARANON,M.;GUTIERREZ,CO;CALVOFLORES,RD"	"Soil Fertility Capability Classification of Northwest Sierra-Nevada (Granada, Spain)"	1989
"CALVOFLORES,RD;CALVOFLORES,GD;MOLINA,ES;MARTINEZ,JP"	"Analysis of some Changes in Soils of Sierra-Nevada (Granada, Spain) Induced by Reforestation with Conifers"	1987
"CAMACHO,JPM;DELAGUARDIA,RD;REJON,MR"	"Polysomy and Supernumerary Isochromosomes in the Grasshopper Omocestus-Bolivari (Chopard)"	1981
"Camarero,L.;Catalan,J.;Pla,S.;Rieradevall,M.;Jimenez,M.;Prat,N.;Rodriguez,A.;Encina,L.;CruzPizarro,L.;Castillo,PS;Carrillo,P.;Toro,M.;Grimalt,J.;Berdie,L.;Fernandez,P.;Vilanova,R."	"Remote mountain lakes as indicators of diffuse acidic and organic pollution in the Iberian peninsula (AL:PE 2 studies)"	1995
"Campos,F.;Gutierrez-Corchero,F.;Hernandez,MA;Rivas,JM;Lopez-Fidalgo,J."	"Biometric differences among the Dipper Cinclus cinclus populations of Spain"	2005
"Carbonell,R.;Sallares,V.;Pous,J.;Danobeitia,JJ;Queralt,P.;Ledo,JJ;Duenas,VG"	"A multidisciplinary geophysical study in the Betic chain (southern Iberia Peninsula)"	1998
"CARRILLO,P.;CRUZPIZARRO,L.;SANCHEZCASTILLO,P."	"Analysis of Phytoplankton-Zooplankton Relationships in an Oligotrophic Lake Under Natural and Manipulated Conditions"	1990
"Carrillo,P.;Reche,I.;CruzPizarro,L."	"Intraspecific stoichiometric variability and the ratio of nitrogen to phosphorus resupplied by zooplankton"	1996
"Carrillo,P.;Reche,I.;CruzPizarro,L."	"Quantification of the phosphorus released by zooplankton in an oligotrophic lake (La Caldera, Spain): Regulating factors and adjustment to theoretical models"	1996
"CARRILLO,P.;RECHE,I.;SANCHEZCASTILLO,P.;CRUZPIZARRO,L."	"Direct and Indirect Effects of Grazing on the Phytoplankton Seasonal Succession in an Oligotrophic Lake"	1995
"CARRILLO,P.;SANCHEZCASTILLO,P.;CRUZPIZARRO,L."	"Coincident Zooplankton and Phytoplankton Diel Migrations in a High Mountain Lake (La Caldera, Sierra-Nevada, Spain)"	1991
"Carrillo,P.;Villar-Argaiz,M.;Medina-Sanchez,JM"	"Relationship between N : P ratio and growth rate during the life cycle of calanoid copepods: An in situ measurement"	2001
"Casas,C.;Blom,HH;Cros,RM"	"Schistidium occidentale from the Sierra Nevada (Spain), new to the European bryophyte flora"	2001
"Casas,J. J.;Vilchez-Quero,A."	"Altitudinal distribution of lotic chironomid (Diptera) communities in the Sierra Nevada mountains (Southern Spain)"	1993
"CASAS,JJ;LAVILLE,H."	"Micropsectra-Seguyi, a New Species of the Attenuata Reiss Group (Diptera, Chironomidae) from Sierra-Nevada (Spain)"	1990
"CASAS,JJ;VILCHEZQUERO,A."	"Cricotopus (Cricotopus) Nevadensis Sp-N (Diptera, Chironomidae) from Sierra-Nevada (Southern Spain)"	1992
"CASAS,JJ;VILCHEZQUERO,A."	"Stempellinella-Reissi Sp-N (Diptera, Chironomidae) from Sierra-Nevada (Southern Spain)"	1991
"Casas,JJ;Zamora-Munoz,C.;Archila,F.;Alba-Tercedor,J."	"The effect of a headwater dam on the use of leaf bags by invertebrate communities"	2000
"CASTILLO,P.;VOVLAS,N."	"Mesocriconema-Kirjanovae (Nematoda, Criconematidae) from Southeastern Spain"	1992
"CASTRO,A.;MORENOVENTAS,I.;DELAROSA,JD"	"Multistage Crystallization of Tonalitic Enclaves in Granitoid Rocks (Hercynian Belt, Spain) - Implications for Magma Mixing"	1991
"Castro,J.;Zamora,R.;Hodar,JA"	"Mechanisms blocking Pinus sylvestris colonization of Mediterranean, mountain meadows"	2002
"Castro,J.;Zamora,R.;Hodar,JA;Gomez,JM;Gomez-Aparicio,L."	"Benefits of using shrubs as nurse plants for reforestation in Mediterranean mountains: A 4-year study"	2004
"Castro,Jorge"	"Short delay in timing of emergence determines establishment success in Pinus sylvestris across microhabitats"	2006
"CLARET,A.;RODRIGUEZ,E.;GARCIA,JM"	"Comparison between Standard Evolution Models for High Amplitude Delta-Sct Stars"	1990
"Clement,R.;Garcia,M.;Reglero,V.;Clausen,JV;Bravo,A.;Suso,J.;Fabregat,J.;Torrejon,JM;Reig,P.;Marco,A."	"Four colour photometry of late-type binary systems .1. First uvby beta light curves of ZZ Ursae Majoris"	1997
"Costillo,Luis P.;Ibanez,J. Miguel;Aparicio,Beatriz;Garcia,Antonio J."	"SNOWS: Sierra Nevada Observatory Weather System - art. no. 62741G"	2006
"Costillo,Luis P.;Ramos,J. Luis;Ibanez,J. Miguel;Aparicio,Beatriz;Herranz,Miguel;Garcia,Antonio J."	"New control system for the 1.5m and 0.9m telescopes at Sierra Nevada Observatory - art. no. 62741I"	2006
"CRESPOBLANC,A."	"Interference Pattern of Extensional Fault Systems - a Case-Study of the Miocene Rifting of the Alboran Basement (North of Sierra-Nevada, Betic Chain)"	1995
"Critelli,S.;Arribas,J.;Le Pera,E.;Tortosa,A.;Marsaglia,KM;Latter,KK"	"The recycled orogenic sand provenance from an uplifted thrust belt, Betic Cordillera, southern Spain"	2003
"Cruz-Pizarro,L.;Conde-Porcuna,JM;Carrillo,P."	"Diel variation in the egg ratio of Hexarthra bulgarica in the high mountain lake La Caldera (Spain)"	1998
"CRUZPIZARRO,L.;MORALES,R."	"Taxonomic and Ecological Notes on Hexarthra-Bulgarica from High Mountain Lakes and Ponds in the Sierra-Nevada (Spain)"	1987
"CRUZPIZARRO,L.;RECHE,I.;CARRILLO,P."	"Plankton Dynamics in a High-Mountain Lake (Las-Yeguas, Sierra-Nevada, Spain) - Indirect Evidence of Ciliates as Food Source of Zooplankton"	1994
"CUEVAS,J."	"Internal Structure of the Adra Nappe (Alpujarride Complex, Betics, Spain)"	1991
"de Figueroa,JMT;Luzon-Ortega,JM;Sanchez-Ortega,A."	"Protandry and its relationship with adult size in some Spanish stoneflies species (Plecoptera)"	2003
"de Figueroa,JMT;Luzon-Ortega,JM;Stewart,KW"	"The drumming of Isoperla pallida aubert and Guadalgenus franzi (Aubert) (Plecoptera, Perlodidae), and review and evolutionary considerations of Southern Iberian Peninsula Perlodidae"	2002
"de Figueroa,JMT;Sanchez-Ortega,A."	"Implications of imaginal-size over the flight period in stoneflies (Plecoptera)"	2004
"De Figueroa,JMT;Sanchez-Ortega,A."	"Imaginal feeding of twelve Nemouroidean stonefly species (Insecta, Plecoptera)"	2000
"De Figueroa,JMT;Sanchez-Ortega,A."	"Imaginal feeding of certain Systellognathan stonefly species (Insecta : Plecoptera)"	1999
"de Galdeano,CS;Alfaro,P."	"Tectonic significance of the present relief of the Betic Cordillera"	2004
"de Galdeano,CS;Lopez-Garrido,AC"	"Nature and impact of the Neotectonic deformation in the western Sierra Nevada (Spain)"	1999
"del Rio,JS;Rojas,ARF;Herpe,G."	"Automatization of a multipurpose astronomical spectrograph"	2000
"Delgado,R.;Sanchez-Maranon,M.;Martin-Garcia,J. M.;Aranda,V.;Serrano-Bernardo,F.;Rosua,J. L."	"Impact of ski pistes on soil properties: a case study from a mountainous area in the Mediterranean region"	2007
"Desjardin,DL"	"A unique ballistosporic hypogeous sequestrate Lactarius from California"	2003
"DOMMERGUES,JL;MOUTERDE,R.;RIVAS,P."	"A False Polymorphid - Dubariceras, a New Genus of the Ammonita from the Mesogean Carixian"	1984
"Donaire,T.;Pascual,E.;Pin,C.;Duthou,JL"	"Microgranular enclaves as evidence of rapid cooling in granitoid rocks: the case of the Los Pedroches granodiorite, Iberian Massif, Spain"	2005
"Donaire,T.;Saez,R.;Pascual,E."	"Rhyolitic globular peperites from the Aznalcollar mining district (Iberian Pyrite Belt, Spain): physical and chemical controls"	2002
"Douglas,T.;Critchley,D.;Park,G."	"The deintensification of terraced agricultural land near Trevelez, Sierra Nevada, Spain"	1996
"DOUGLAS,TD;KIRKBY,SJ;CRITCHLEY,RW;PARK,GJ"	"Agricultural Terrace Abandonment in the Alpujarra, Andalusia, Spain"	1994
"ECHEVARRIA,F.;CARRILLO,P.;JIMENEZ,F.;SANCHEZCASTILLO,P.;CRUZPIZARRO,L.;RODRIGUEZ,J."	"The Size Abundance Distribution and Taxonomic Composition of Plankton in an Oligotrophic, High Mountain Lake (La-Caldera, Sierra-Nevada, Spain)"	1990
"Errard,Christine;Ruano,Francisca;Richard,Freddie-Jeanne;Lenoir,Alain;Tinaut,Alberto;Hefetz,Abraham"	"Co-evolution-driven cuticular hydrocarbon variation between the slave-making ant Rossomyrmex minuchae and its host Proformica longiseta (Hymenoptera : Formicidae)"	2006
"ESCOS,J.;ALADOS,CL"	"Influence of Weather and Population Characteristics of Free-Ranging Spanish Ibex in the Sierra-De-Cazorla-Y-Segura and in the Eastern Sierra-Nevada"	1991
"ESCOS,J.;ALADOS,CL;EMLEN,JM"	"Application of the Stage-Projection Model with Density-Dependent Fecundity to the Population-Dynamics of Spanish Ibex"	1994
"Escudero,IF;Tinaut,A.;Ruano,F."	"Ovarian maturation under cold winter conditions in a high-mountain ant (Hymenoptera : Formicidae)"	1997
"Estelles,V.;Utrillas,M. P.;Martinez-Lozano,J. A.;Alcantara,A.;Alados-Arboledas,L.;Olmo,F. J.;Lorente,J.;de Cabo,X.;Cachorro,V.;Horvath,H.;Labajo,A.;Sorribas,M.;Diaz,J. P.;Diaz,A. M.;Silva,A. M.;Elias,T.;Pujadas,M.;Rodrigues,J. A.;Canada,J.;Garcia,Y."	"Intercomparison of spectroradiometers and Sun photometers for the determination of the aerosol optical depth during the VELETA-2002 field campaign"	2006
"FAVARGER,C.;FELINER,GN"	"On the Races of Arenaria-Tetraquetra L (Caryophyllaceae)"	1988
"FERNANDEZ,I.;BALLESTA,M.;TINAUT,A."	"Worker Polymorphism in Proformica-Longiseta (Hymenoptera, Formicidae)"	1994
"Fernandez-Escudero,I.;Pamilo,P.;Seppa,P."	"Biased sperm use by polyandrous queens of the ant Proformica longiseta"	2002
"Fernandez-Escudero,I.;Tinaut,A."	"Factors determining nest distribution in the high-mountain ant Proformica longiseta (Hymenoptera Formicidae)"	1999
"Fernandez-Escudero,I.;Tinaut,A."	"Heat-cold dialectic in the activity of Proformica longiseta, a thermophilous ant inhabiting a high mountain (Sierra Nevada, Spain)"	1998
"Fernandez-Fernandez,E. M.;Jabaloy-Sanchez,A.;Nieto,F.;Gonzalez-Lodeiro,F."	"Structure of the Malaguide Complex near Velez Rubio (Eastern Betic Cordillera, SE spain)"	2007
"Fernandez-Gutierrez,A.;Cruces-Blanco,C.;Cortacero-Ramirez,S.;Segura-Carretero,A."	"Sensitive determination of inorganic anions at trace levels in samples of snow water from Sierra Nevada (Granada, Spain) by capillary ion electrophoresis using calix[4]arene as selective modifier"	2000
"Forister,Matthew L.;Fordyce,James A.;Nice,Chris C.;Gompert,Zachariah;Shapiro,Arthur M."	"Egg morphology varies among populations and habitats along a suture zone in the Lycaeides idas-melissa species complex (Lepidoptera : Lycaenidae)"	2006
"FRAHM,JP"	"Philonotis-Hastata (Dub) Wijk and Marg, New in Europe"	1976
"Fresneda,J.;Ribera,I."	"Revision of the Limnebius nitidus (Marsham) subgroup (Coleoptera : Hydraenidae), with description of two new species and comments on their phylogeny and biogeography"	1998
"Fuertes,E.;Olivan,G.;Acon,M."	"Warnstorfia (Bryopsida, Calliergonaceae) in the Iberian peninsula"	2006
"Galan,G.;Pin,C.;Duthou,JL"	"Sr-Nd isotopic record of multi-stage interactions between mantle-derived magmas and crustal components in a collision context - The ultramafic-granitoid association from Vivero (Hercynian belt, NW Spain)"	1996
"Galindo-Zaldivar,J.;Gil,AJ;Borque,MJ;Gonzalez-Lodeiro,F.;Jabaloy,A.;Marin-Lechado,C.;Ruano,P.;de Galdeano,CS"	"Active faulting in the internal zones of the central Betic Cordilleras (SE, Spain)"	2003
"GALINDOZALDIVAR,J.;GONZALEZLODEIRO,F.;JABALOY,A."	"Progressive Extensional Shear Structures in a Detachment Contact in the Western Sierra-Nevada (Betic-Cordilleras, Spain)"	1989
"Galindo-Zaldivar,Jesus;Gil,Antonio;de Galdeano,Carlos Sanz;Shanov,Stefan;Stanica,Dumitru"	"Monitoring of active tectonic structures in Central Betic Cordillera (southern Spain)"	2007
"Garcia,AF;Zhu,Z.;Ku,TL;de Galdeano,CS;Chadwick,OA;Montero,JC"	"Tectonically driven landscape development within the eastern Alpujarran Corridor, Betic Cordillera, SE Spain (Almeria)"	2003
"GARCIA,CM;ECHEVARRIA,F.;NIELL,FX"	"Size Structure of Plankton in a Temporary, Saline Inland Lake"	1995
"Garcia,D."	"Interaction between Juniperus communis L. and its fruit pest insects: Pest abundance, fruit characteristics and seed viability"	1998
"Garcia,D.;Zamora,R.;Gomez,JM;Hodar,JA"	"Bird rejection of unhealthy fruits reinforces the mutualism between juniper and its avian dispersers"	1999
"Garcia,D.;Zamora,R.;Hodar,JA;Gomez,JM"	"Age structure of Juniperus communis L. In the Iberian peninsula: Conservation of remnant populations in Mediterranean mountains"	1999
"Garcia,D.;Zamora,R.;Hodar,JA;Gomez,JM;Castro,J."	"Yew (Taxus baccata L.) regeneration is facilitated by fleshy-fruited shrubs in Mediterranean environments"	2000
"Gil,AJ;Rodriguez-Caderot,G.;Lacy,MC;Ruiz,AM;de Galdeano,CS;Alfaro,P."	"Establishment of a non-permanent GPS network to monitor the recent NE-SW deformation in the Granada Basin (Betic Cordillera, southern Spain)"	2002
"Gomez Ortiz,Antonio;Plana Castellvi,Josep A."	"The little ice age in Sierra Nevada through the period writers (18th and 19th centuries) in its relation to the progress of physical geography and Spanish geomorphology"	2006
"Gomez,A.;Palacios,D.;Luengo,E.;Tanarro,LM;Schulte,L.;Ramos,M."	"Talus instability in a recent deglaciation area and its relationship to buried ice and snow cover evolution (Picacho del Veleta, Sierra Nevada, Spain)"	2003
"Gomez,A.;Palacios,D.;Ramos,M.;Tanarro,LM;Schulte,L.;Salvador,F."	"Location of permafrost in marginal regions: Corral del Veleta, Sierra Nevada, Spain"	2001
"Gomez,JM"	"Long-term effects of ungulates on performance, abundance, and spatial distribution of two montane herbs"	2005
"Gomez,JM"	"Non-additive effects of herbivores and pollinators on Erysimum mediohispanicum (Cruciferae) fitness"	2005
"Gomez,JM"	"Herbivory reduces the strength of pollinator-mediated selection in the Mediterranean herb Erysimum mediohispanicum: Consequences for plant specialization"	2003
"Gomez,JM"	"Self-pollination in Euphrasia willkommii Freyn (Scrophulariaceae), an endemic species from the alpine of the Sierra Nevada (Spain)"	2002
"GOMEZ,JM"	"Importance of Direct and Indirect Effects in the Interaction between a Parasitic Angiosperm (Cuscuta-Epithymum) and its Host-Plant (Hormathophylla-Spinosa)"	1994
"GOMEZ,JM"	"Phenotypic Selection on Flowering Synchrony in a High-Mountain Plant, Hormathophylla-Spinosa (Cruciferae)"	1993
"Gomez,JM;Garcia,D."	"Interactions between a high-mountain shrub, Genista versicolor (Fabaceae), and its seed predators"	1997
"Gomez,JM;Garcia,D.;Zamora,R."	"Impact of vertebrate acorn- and seedling-predators on a Mediterranean Quercus pyrenaica forest"	2003
"Gomez,JM;Gonzalez-Megias,A."	"Asymmetrical interactions between ungulates and phytophagous insects: Being different matters"	2002
"Gomez,JM;Hodar,JA;Zamora,R.;Castro,J.;Garcia,D."	"Ungulate damage on Scots pines in Mediterranean environments: effects of association with shrubs"	2001
"Gomez,JM;Zamora,R."	"Spatial variation in the selective scenarios of Hormathophylla spinosa (Cruciferae)"	2000
"Gomez,JM;Zamora,R."	"Differential impact of vertebrate and invertebrate herbivores on the reproductive output of Hormathophylla spinosa"	2000
"Gomez,JM;Zamora,R."	"Generalization vs. specialization in the pollination system of Hormathophylla spinosa (Cruciferae)"	1999
"Gomez,JM;Zamora,R."	"Wind pollination in high-mountain populations of Hormathophylla spinosa (Cruciferae)"	1996
"GOMEZ,JM;ZAMORA,R."	"Top-Down Effects in a Tritrophic System - Parasitoids Enhance Plant Fitness"	1994
"GOMEZ,JM;ZAMORA,R."	"Pollination by Ants - Consequences of the Quantitative Effects on a Mutualistic System"	1992
"Gomez,JM;Zamora,R.;Hodar,JA;Garcia,D."	"Experimental study of pollination by ants in Mediterranean high mountain and arid habitats"	1996
"Gomez,Jose M.;Bosch,Jordi;Perfectti,Francisco;Fernandez,Juande;Abdelaziz,Mohamed"	"Pollinator diversity affects plant reproduction and recruitment: the tradeoffs of generalization"	2007
"Gomez-Aparicio,L.;Gomez,JM;Zamora,R.;Boettinger,JL"	"Canopy vs. soil effects of shrubs facilitating tree seedlings in Mediterranean montane ecosystems"	2005
"Gomez-Aparicio,L.;Zamora,R.;Gomez,JM;Hodar,JA;Castro,J.;Baraza,E."	"Applying plant facilitation to forest restoration: A meta-analysis of the use of shrubs as nurse plants"	2004
"Gomez-Pugnaire,MT;Galindo-Zaldivar,J.;Rubatto,D.;Gonzalez-Lodeiro,F.;Sanchez-Vizcaino,VL;Jabaloy,A."	"A reinterpretation of the Nevado-Filabride and Alpujarride Complexes (Betic Cordillera): field, petrography and U-Pb ages from orthogneisses (western Sierra Nevada, S Spain)"	2004
"Gonzalez-Megias,A.;Gomez,JM"	"Consequences of removing a keystone herbivore for the abundance and diversity of arthropods associated with a cruciferous shrub"	2003
"Gonzalez-Megias,A.;Gomez,JM"	"Adult and larval plant range and preference in Timarcha lugens (Coleoptera : Chrysomelidae): Strict monophagy on an atypical host"	2001
"Gonzalez-Megias,A.;Gomez,JM;Sanchez-Pinero,F."	"Regional dynamics of a patchily distributed herbivore along an altitudinal gradient"	2005
"Gonzalez-Megias,A.;Gomez,JM;Sanchez-Pinero,F."	"Consequences of spatial autocorrelation for the analysis of metapopulation dynamics"	2005
"Gonzalez-Megias,A.;Gomez,JM;Sanchez-Pinero,F."	"Effects of ungulates on epigeal arthropods in Sierra Nevada National Park (southeast Spain)"	2004
"Gonzalez-Megias,Adela;Maria Gomez,Jose;Sanchez-Pinero,Francisco"	"Diversity-habitat heterogeneity relationship at different spatial and temporal scales"	2007
"GOZMANY,LA"	"New Symmocid Species (Lepidoptera) and Description of an Unknown Abdominal Organ"	1975
"Granados,JE;Fandos,P.;Marquez,FJ;Soriguer,RC;Chirosa,M.;Perez,JM"	"Allometric growth in the Spanish ibex, Capra pyrenaica"	2001
"Granados,JE;Perez,JM;Soriguer,C.;Fandos,P.;RuizMartinez,I."	"On the biometry of the Spanish ibex, Capra pyrenaica, from Sierra Nevada (Southern Spain)"	1997
"Guerra,J.;Cano,M. J.;Heras,P."	"Morphological variability and new records of Pohlia bolanderi (Lesq.) Broth. (Mielichhoferiaceae, Bryophyta) in the Iberian Peninsula"	2007
"Hader,DP;Lebert,M.;Marangoni,R.;Colombetti,G."	"ELDONET - European Light Dosimeter Network hardware and software"	1999
"Haeseler,V."	"Nest breaking, theft of provisions and brood parasitism in the digger wasp Ammophila hungarica Mocsary 1883 (Hymenoptera, Sphecidae)"	1995
"Herpe,G.;Vanderriest,C.;del Rio,JS;del Olmo,A."	"The ARGUS mode of the ALBIREO spectrograph: Evaluation of its performance and first results"	1998
"Hervas,J.;Lopez,S.;de Lara,FCM;Arias,J.;Carrasco,L.;Gomez-Villamandos,JC"	"Adenovirus infection in Spanish ibex"	1998
"Hodar,JA;Castro,J.;Zamora,R."	"Pine processionary caterpillar Thaumetopoea pityocampa as a new threat for relict Mediterranean Scots pine forests under climatic warming"	2003
"Hodar,JA;Zamora,R."	"Herbivory and climatic warming: a Mediterranean outbreaking caterpillar attacks a relict, boreal pine species"	2004
"Hodar,JA;Zamora,R.;Castro,J."	"Host utilisation by moth and larval survival of pine processionary caterpillar Thaumetopoea pityocampa in relation to food quality in three Pinus species"	2002
"Hodar,JA;Zamora,R.;Castro,J.;Baraza,E."	"Feast and famine: previous defoliation limiting survival of pine processionary caterpillar Thaumetopoea pityocampa in Scots pine Pinus sylvestris"	2004
"IGNACIO,FE;TINAUT,A.;RUANO,F."	"Rock Selection for Nesting in Proformica-Longiseta Collingwood, 1978 (Hymenoptera, Formicidae) in a Mediterranean High Mountain"	1993
"Jenkins,TM;Diehl,S.;Kratz,KW;Cooper,SD"	"Effects of population density on individual growth of brown trout in streams"	1999
"Jerome,CA;Ford,BA"	"The discovery of three genetic races of the dwarf mistletoe Arceuthobium americanum (Viscaceae) provides insight into the evolution of parasitic angiosperms"	2002
"Johnson,C."	"Resolving denudational histories in orogenic belts with apatite fission-track thermochronology and structural data: An example from southern Spain"	1997
"Johnson,C.;Harbury,N.;Hurford,AJ"	"The role of extension in the miocene denudation of the Nevado-Filabride complex, Betic Cordillera (SE Spain)"	1997
"Kropf,Matthias;Comes,Hans Peter;Kadereit,Joachim W."	"Long-distance dispersal vs vicariance: the origin and genetic diversity of alpine plants in the Spanish Sierra Nevada"	2006
"Lango,Z.;Toth,LG;Kovacs,G.;Cruz-Pizarro,L."	"Identification and biochemical characterization of Streptomyces galbus from the sediment of the high-mountain lake La Caldera (Sierra Nevada, Spain)"	1999
"LARA,F."	"New Localities for Orthotrichum-Ibericum in Spain"	1994
"Larena,Belen Gutierrez;Aguilar,Javier Fuertes;Feliner,Gonzalo Nieto"	"Dispersal across Southern Iberian refugia? Integrating rapds, sequence data and morphometrics in Armeria (Plumbaginaceae)"	2006
"Larena,BG;Aguilar,JF;Feliner,GN"	"Glacial-induced altitudinal migrations in Armeria (Plumbaginaceae) inferred from patterns of chloroplast DNA haplotype sharing"	2002
"LEBRETON,P.;LARACINEPITTET,C.;BAYET,C.;LAURANSON,J."	"Polyphenol Variability and Systematics of the Scots Pine (Pinus-Sylvestris L)"	1990
"Lewis,CJ;Verges,J.;Marzo,M."	"High mountains in a zone of extended crust: Insights into the Neogene-Quaternary topographic development of northeastern Iberia"	2000
"Linares-Cuesta,J. Eduardo;Sanchez-Castillo,Pedro M."	"Fragilaria nevadensis sp nov., a new diatom taxon from a high mountain lake in the Sierra Nevada (Granada, Spain)"	2007
"Liu,ZL;Zhou,AY;Rodriguez,E."	"Photometric observations of the delta Scuti star UV Trianguli and its evolutionary status"	2002
"Liu,ZL;Zhou,AY;Rodriguez,E."	"The mode identification and physical parameter determination of the delta Scuti star SAO 16394"	2000
"Lopez-Gonzalez,M. J.;Rodriguez,E.;Shepherd,G. G.;Shepherd,M. G.;Sargoytchev,S.;Aushev,V. M.;Garcia-Comas,M.;Brown,S.;Wiens,H."	"O-2 Atmospheric band and OH(6-2) airglow and temperature variability over Spain using SATI observations: Planetary-scale oscillations during autumn"	2007
"Lorite,J.;Navarro,F. B.;Valle,F."	"Estimation of threatened orophytic flora and priority of its conservation in the Baetic range (S. Spain)"	2007
"Lorite,Juan;Ruiz-Girela,Mario;Castro,Jorge"	"Patterns of seed germination in Mediterranean mountains: Study on 37 endemic or rare species from Sierra Nevada, SE Spain"	2007
"Martinez,JRF;Zuazo,VHD;Raya,AM"	"Environmental impact from mountainous olive orchards under different soil-management systems (SE Spain)"	2006
"Martinez,T."	"Summer feeding strategy of Spanish ibex Capra pyrenaica and domestic sheep Ovis aries in south-eastern Spain"	2002
"Martinez,T."	"Diet selection by Spanish ibex in early summer in Sierra Nevada"	2000
"MARTINEZ,T."	"Micrographic Analyze of Feces to Study Alimentary Diet of Wildgoat in the Sierra-Nevada (Spain)"	1988
"Martinez-Martinez,J. M.;Soto,J. I.;Balanya,J. C."	"Elongated domes in extended orogens: A mode of mountain uplift in the Betics (southeast Spain)"	2004
"Martinez-Martinez,JM"	"Lateral interaction between metamorphic core complexes and less-extended, tilt-block domains: the Alpujarras strike-slip transfer fault zone (Betics, SE Spain)"	2006
"MartinezMartinez,JM;Azanon,JM"	"Mode of extensional tectonics in the southeastern Betics (SE Spain): Implications for the tectonic evolution of the peri-Alboran orogenic system"	1997
"Martinez-Martinez,JM;Soto,JI;Balanya,JC"	"Orthogonal folding of extensional detachments: Structure and origin of the Sierra Nevada elongated dome (Betics, SE Spain)"	2002
"Martinez-Martinez,JM;Soto,JI;Balanya,JC"	"Crustal decoupling and intracrustal flow beneath domal exhumed core complexes, Betics (SE Spain)"	1997
"Martin-Garcia,JM;Aranda,V.;Gamiz,E.;Bech,J.;Delgado,R."	"Are Mediterranean mountains Entisols weakly developed? The case of orthents from Sierra Nevada (Southern Spain)"	2004
"Martin-Garcia,JM;Delgado,G.;Parraga,JF;Bech,J.;Delgado,R."	"Mineral formation in micaceous Mediterranean Red soils of Sierra Nevada, Granada, Spain"	1998
"Martin-Garcia,JM;Delgado,G.;Parraga,JF;Gamiz,E.;Delgado,R."	"Chemical, mineralogical and (micro)morphological study of coarse fragments in Mediterranean Red Soils"	1999
"Martin-Piera,F.;Boto,L."	"A reappraisal of the 'fracticornis-opacicollis' taxonomic complex of the genus Onthophagus Latreille using allozymes (Coleoptera, Scarabaeoidea)"	1999
"MARTINRAMOS,JD;RODRIGUEZGALLEGO,M."	"Chromian Mica from Sierra-Nevada, Spain"	1982
"Martin-Vivaldi,M.;Palomino,JJ;Soler,M."	"Function of song in the Hoopoe Upupa epops"	1999
"Martin-Vivaldi,M.;Palomino,JJ;Soler,M."	"Song structure in the Hoopoe (Upupa epops) - Strophe length reflects male condition"	1998
"Martin-Vivaldi,M.;Palomino,JJ;Soler,M.;Martinez,JG"	"Song strophe-length and reproductive success in a non-passerine bird, the Hoopoe Upupa epops"	1999
"Matthews,KR;Pope,KL"	"A telemetric study of the movement patterns and habitat use of Rana muscosa, the mountain yellow-legged frog, in a high-elevation basin in Kings Canyon National Park, California"	1999
"MAYORAL,E.;CRESPOBLANC,A.;DIAZ,MD;BENOT,C.;OROZCO,M."	"Miocene Rifting of the Alboran Domain - Datings of Discordant Sediments Over the Alpujarride Extensional Units (South of Sierra-Nevada, Betic Chain)"	1994
"MAYORAL,E.;CRESPOBLANC,A.;DIAZ,MDG;BENOT,C.;OROZCO,M."	"Miocene Rifting of the Alboran Domain - Datings of Discordant Sediments Over the Alpujarride Extensional Units (South of Sierra-Nevada, Betic Chain) - Reply"	1995
"Merz,B."	"Two new Tephritidae (Diptera) from the Western Palaearctic region"	2000
"Meyer,Marc D.;North,Malcolm P.;Gray,Andrew N.;Zald,Harold S. J."	"Influence of soil thickness on stand characteristics in a Sierra Nevada mixed-conifer forest"	2007
"Miralles,I.;Ortega,R.;Sanchez-Maranon,M.;Leiros,M. C.;Trasar-Cepeda,C.;Gil-Sotres,F."	"Biochemical properties of range and forest soils in Mediterranean mountain environments"	2007
"Moleon,M.;Gil-Sanchez,JM"	"Food habits of the wildcat (Felis silvestris) in a peculiar habitat: the Mediterranean high mountain"	2003
"Molina,JA"	"Oligotrophic spring vegetation in Spanish mountain ranges"	2001
"Montero,FE;Acosta,RM;Pozo,BG;Ruiz,PB;Mendez,JL;Rivas,SA;Martin,JI"	"Exposure to Mycobacterium tuberculosis during a bus travel"	2001
"MORALESBAQUERO,R."	"Body Size Variability of Euchlanis-Dilatata Ehrenberg in High Mountain Lakes of Sierra-Nevada (Spain)"	1988
"MORALESBAQUERO,R."	"Rotifer Fauna of Lakes and Ponds Over 2500m Above Sea-Level in the Serra Nevada, Spain, with Description of a New Subspecies"	1987
"Morales-Baquero,R.;Carrillo,P.;Barea-Arco,J.;Perez-Martinez,C.;Villar-Argaiz,M."	"Climate-driven changes on phytoplankton-zooplankton coupling and nutrient availability in high mountain lakes of Southern Europe"	2006
"Morales-Baquero,R.;Carrillo,R.;Reche,I.;Sanchez-Castillo,P."	"Nitrogen-phosphorus relationship in high mountain lakes: effects of the size of catchment basins"	1999
"Morales-Baquero,R.;Conde-Porcuna,J. M."	"Effect of the catchment areas on the abundance of zooplankton in high mountain lakes of the Sierra Nevada (Spain)"	2001
"MoralesBaquero,R.;CruzPizarro,L."	"Effects of fluctuating temperatures on the population dynamics of Hexarthra bulgarica (Wiszniewski) from high mountain lakes in Sierra Nevada (Spain)"	1995
"MORALESBAQUERO,R.;CRUZPIZARRO,L.;CARRILLO,P."	"Patterns in the Composition of the Rotifer Communities from High Mountain Lakes and Ponds in Sierra-Nevada (Spain)"	1989
"MORALESBAQUERO,R.;CRUZPIZARRO,L.;CARRILLO,P."	"Biomass and Production of Euchlanis-Dilatata in High Mountain Lakes and Ponds of Sierra-Nevada (Spain)"	1988
"Morales-Baquero,R.;Pulido-Villena,E.;Reche,I."	"Atmospheric inputs of phosphorus and nitrogen to the southwest Mediterranean region: Biogeochemical responses of high mountain lakes"	2006
"Moreno,G.;Sanchez,A.;Castillo,A.;Singer,H.;Illana,C."	"Nivicolous myxomycetes from the Sierra Nevada National Park (Spain)"	2003
"Moreno-Rueda,Gregorio;Rivas,Jose M."	"Recent changes in allometric relationships among morphological traits in the dipper (Cinclus cinclus)"	2007
"MORTEN,L.;PUGA,E."	"Blades of Olivines and Orthopyroxenes in Ultramafic Rocks from the Cerro-Del-Almirez, Sierra-Nevada Complex, Spain - Relics of Quench-Textured Harzburgites"	1984
"Moscoso,DJ"	"Obstacles and opportunities for mountain development in Andalusia (Spain) - The experience of the European Union LEADER Initiative for rural development in the Sierra Nevada"	2006
"Mota,JF;Perez-Garcia,FJ;Jimenez,ML;Amate,JJ;Penas,J."	"Phytogeographical relationships among high mountain areas in the Baetic Ranges (South Spain)"	2002
"Murashkina,M. A.;Southard,R. J.;Pettygrove,G. S."	"Potassium fixation in San Joaquin Valley soils derived from granitic and nongranitic alluvium"	2007
"OLOWOKUDEJO,JD"	"The Morphological Variation and Geographical-Distribution of Biscutella-Glacialis (Boiss-Et-Reuter) Jordan in Spain"	1986
"ORANTESBERMEJO,FJ;GARCIAFERNANDEZ,P."	"Morphological Variability of Apis-Mellifera-Iberica in Different Apiaries of Southern Spain"	1995
"Orozco,M.;Alonso-Chaves,FM;Nieto,F."	"Development of large north-facing folds and their relation to crustal extension in the Alboran domain (Alpujarras region, Betic Cordilleras, Spain)"	1998
"Orozco,M.;Alvarez-Valero,AM;Alonso-Chaves,FM;Platt,JP"	"Internal structure of a collapsed terrain The Lujar syncline and its significance for the fold- and sheet-structure of the Alboran Domain (Betic Cordilleras, Spain)"	2004
"Orozco,M.;Molina,JM;Crespo-Blanc,A.;Alonso-Chaves,FM"	"Palaeokarst and rauhwacke development, mountain uplift and subaerial sliding of tectonic sheets (northern Sierra de los Filabres, Betic Cordilleras, Spain)"	1999
"Ortega,A.;Esteve-Raventos,F."	"On the presence of Russula laccata in Sierra Nevada (Andalucia, southern Spain) and its taxonomic relationships with R. norvegica"	2001
"Ortega,A.;Esteve-Raventos,F."	"Contribution to the knowledge of Pezizales (Ascomycota) from Andalusia (Spain)"	2001
"Ortiz,AG;Schulte,L.;Franch,FS"	"Research on recent glaciation and related morphology based on the Corral del Veleta (Sierra Nevada)"	1996
"Ortiz,JL;Gutierrez,PJ;Casanova,V.;Sota,A."	"A study of short term rotational variability in TNOs and Centaurs from Sierra Nevada Observatory"	2003
"Ortiz,PL;Arista,M.;Talavera,S."	"Sex ratio and reproductive effort in the dioecious Juniperus communis subsp alpina (Suter) Celak. (Cupressaceae) along an altitudinal gradient"	2002
"PACE,R."	"Species Belonging to the Genus Geostiba Thomson Collected by Besuchet,c. and Collaborators in Morocco, Iberian and Balkan Peninsula and in Middle-East (Coleoptera, Staphylinidae)"	1983
"Padial,JM;Avila,E.;Gil-Sanchez,JM"	"Feeding habits and overlap among red fox (Vulpes vulpes) and stone marten (Martes foina) in two Mediterranean mountain habitats"	2002
"Pala-Paul,J.;Perez-Alonso,MJ;Velasco-Negueruela,A.;Varade,J.;Villa,AM;Sanz,J.;Brophy,JJ"	"Analysis of the essential oil composition from the different parts of Eryngium glaciale Boiss. from Spain"	2005
"PANEK,E.;ZAWODNY,Z."	"Trace-Metals in the Roadside Mountain Soils of Sierra-Nevada, Spain"	1993
"Peixinho,N.;Lacerda,P.;Ortiz,JL;Doressoundiram,A.;Roos-Serote,M.;Gutierrez,PJ"	"Photometric study of Centaurs 10199 Chariklo (1997 CU26) and 1999 UG(5)"	2001
"PEREIRA,I.;CASARES,M.;LLIMONA,X."	"Notes on the Hydrophilic Lichens of the Sierra-Nevada of Southern Spain (Granada)"	1987
"Perez,J. M.;Granados,J. E.;Moreno,V.;Calaburg,G.;Moco,G.;Serrano,E."	"In vitro rearing Oestrus caucasicus third-instar larvae and pupae (Diptera : Oestridae) from naturally-infested Iberian ibex, Capra pyrenaica (Artiodactyla : Bovidae)"	2006
"Perez,JM;Gonzalez,FJ;Granados,JE;Perez,MC;Fandos,P.;Soriguer,RC;Serrano,E."	"Hematologic and biochemical reference intervals for Spanish ibex"	2003
"Perez,JM;Granados,JE;Gonzalez,FJ;Ruiz-Martinez,I.;Soriguer,RC"	"Hematologic parameters of the Spanish ibex (Capra pyrenaica)"	1999
"Perez,JM;Granados,JE;Perez,MC;Marquez,FJ;Ferroglio,E.;Rossi,L."	"A survey of the gastrointestinal nematodes of Spanish ibex (Capra pyrenaica) in a high mountain habitat"	2003
"Perez,JM;Granados,JE;RuizMartinez,I.;Chirosa,M."	"Capturing Spanish ibexes with corral traps"	1997
"PEREZ,JM;GRANADOS,JE;SORIGUER,RC"	"Population-Dynamic of the Spanish Ibex Capra-Pyrenaica in Sierra-Nevada-Natural-Park (Southern Spain)"	1994
"Perez,JM;Granados,JE;Soriguer,RC;RuizMartinez,I."	"Prevalence and seasonality of Oestrus caucasicus Grunin, 1948 (Diptera: Oestridae) parasitizing the Spanish ibex, Capra pyrenaica (Mammalia: Artiodactyla)"	1996
"Perez-Martinez,C.;Barea-Arco,J.;Sanchez-Castillo,P."	"Dispersal and colonization of the epibiont alga Korshikoviella gracilipes (Chlorophyceae) on Daphnia pulicaria (Cladocera)"	2001
"Perez-Martinez,Carmen;Barea-Arco,Jose;Sanchez-Castillo,Pedro"	"Life history of the epizoic chlorophyte Korshikoviella gracilipes (Lambert) Silva on Daphnia pulicaria forbes"	1997
"Pinori,S.;Bellucci,G."	"Imaging spectroscopy of selected regional dark mantle deposits of the Moon"	2001
"PUGA,E."	"Existence of Eclogites in Sierra-Nevada Complex (Betic Cordilleras, South of Spain) and their Probable Origin in Mesozoic-Oceanic Crust"	1977
"PulidoBosch,A.;BenSbih,Y.;Vallejos,A."	"Some aspects of the functioning of careos determined by tracer experiments: Example of La Alpujarra (Spain)"	1997
"PulidoBosch,A.;Gisbert,J.;AlAlwani,G."	"Environmental impact of construction work at the Sierra Nevada ski resort in Spain"	1997
"PULIDOBOSCH,A.;SBIH,YB"	"Centuries of Artificial Recharge on the Southern Edge of the Sierra-Nevada (Granada, Spain)"	1995
"Rams,S.;Ros,MR;Cano,MJ;Guerra,J."	"Some interesting bryophyte records from Sierra Nevada (southern Spain)"	2005
"Rams,S.;Ros,RM;Werner,O.;Shaw,AJ"	"Pohlia bolanderi from Sierra Nevada, Spain, new to the European bryophyte flora"	2004
"Rams,Susana;Ros,Rosa M.;Werner,Olaf"	"Tortella alpicola (Pottiaceae) from Spain, new to western Europe"	2006
"Raya,AM;Zuazo,VHD;Martinez,JRF"	"Soil erosion and runoff response to plant-cover strips on semiarid slopes (se spain)"	2006
"Real,M.;Rieradevall,M.;Prat,N."	"Chironomus species (Diptera : Chironomidae) in the profundal benthos of Spanish reservoirs and lakes: factors affecting distribution patterns"	2000
"Reche,I.;Carrillo,P.;CruzPizarro,L."	"Influence of metazooplankton on interactions of bacteria and phytoplankton in an oligotrophic lake"	1997
"Reche,I.;Pulido-Villena,E.;Conde-Porcuna,JM;Carrillo,P."	"Photoreactivity of dissolved organic matter from high-mountain lakes of Sierra Nevada, Spain"	2001
"Reche,I.;Pulido-Villena,E.;Morales-Baquero,R.;Casamayor,EO"	"Does ecosystem size determine aquatic bacterial richness?"	2005
"RECHE,I.;SANCHEZCASTILLO,P.;CARRILLO,P."	"The Principal Regulating Mechanism on the Structure of the Phytoplankton Community in a High-Mountain Lake"	1994
"Reinhardt,L. J.;Bishop,Paul;Hoey,T. B.;Dempster,T. J.;Sanderson,D. C. W."	"Quantification of the transient response to base-level fall in a small mountain catchment: Sierra Nevada, southern Spain"	2007
"Reinhardt,L. J.;Dempster,T. J.;Shroder,J. F., Jr.;Persano,C."	"Tectonic denudation and topographic development in the Spanish Sierra Nevada"	2007
"Reinhardt,Liam J.;Hoey,T. B.;Barrows,T. T.;Dempster,T. J.;Bishop,P.;Fifield,L. K."	"Interpreting erosion rates from cosmogenic radionuclide concentrations measured in rapidly eroding terrain"	2007
"Rieradevall,M.;Jimenez,M.;Prat,N."	"The zoobenthos of six remote high mountain lakes in Spain and Portugal"	1998
"Rivera,D.;Obon,C.;Alcaraz,F.;Llorach,R."	"Systematics of the high mountain taxa of the genus Sideritis L. section Sideritis, subsection Fruticulosae Obon & D. Rivera (Lamiaceae)"	1999
"Rodriguez,E.;Lopez-Gonzalez,MJ;Costa,V."	"Planetary transit across HD 209458 using uvby photometry"	2002
"RODRIGUEZ,E.;ROLLAND,A.;DECOCA,PL"	"Simultaneous Uvby-Beta Photometry of Sx Phoenicis Stars"	1993
"RODRIGUEZ,J.;ECHEVARRIA,F.;JIMENEZGOMEZ,F."	"Physiological and Ecological Scalings of Body Size in an Oligotrophic, High Mountain Lake (La Caldera, Sierra-Nevada, Spain)"	1990
"Rodriguez-Fernandez,J.;de Galdeano,C."	"Late orogenic intramontane basin development: the Granada basin, Betics (southern Spain)"	2006
"Rodriguez-Rodriguez,M.;Moreno-Ostos,E.;De Vicente,I.;Cruz-Pizarro,L.;Da Silva,SLR"	"Thermal structure and energy budget in a small high mountain lake: La Caldera, Sierra Nevada, Spain"	2004
"Ros,R. M.;Rams,S.;Holyoak,D. T.;Brugues,M.;Cros,R. M."	"Revision of the records of Brachymenium commutatum (Bryophyta, Bryaceae) in Europe"	2007
"Ruano,F.;Hefetz,A.;Lenoir,A.;Francke,W.;Tinaut,A."	"Dufour's gland secretion as a repellent used during usurpation by the slave-maker ant Rossomyrmex minuchae"	2005
"Ruano,F.;Tinaut,A."	"Mating behaviour in a slave-making ant, Rossomyrmex minuchae (Hymenoptera, Formicidae)"	2005
"Rueda,Francisco;Moreno-Ostos,Enrique;Cruz-Pizarro,Luis"	"Spatial and temporal scales of transport during the cooling phase of the ice-free period in a small high-mountain lake"	2007
"Ruiz,AM;Ferhat,G.;Alfaro,P.;de Galdeano,CS;de Lacy,MC;Rodriguez-Caderot,G.;Gil,AJ"	"Geodetic measurements of crustal deformation on NW-SE faults of the Betic Cordillera, southern Spain, 1999-2001"	2003
"SAINZCANTERO,CE;ALBATERCEDOR,J."	"Hydraena (Haenydra) Tatii Sp-N from Southern Spain (Coleoptera, Hydraenidae)"	1989
"Salinas,MJ;Blanca,G.;Romero,AT"	"Riparian vegetation and water chemistry in a basin under semiarid Mediterranean climate, Andarax River, Spain"	2000
"SANCHEZCASTILLO,PM"	"Study of the Life-Cycle of Korshikoviella-Gracilipes (Lambert) Silva (Chlorococcales, Chlorophyta)"	1987
"SANCHEZCASTILLO,PM"	"A New Taxon of the Genus Chromulina - Chromulina-Nevadensis Sanchez,p.M. Sp-Nov"	1987
"SanchezMaranon,M.;Delgado,R.;Parraga,J.;Delgado,G."	"Multivariate analysis in the quantitative evaluation of soils for reforestation in the Sierra Nevada (southern Spain)"	1996
"Sanchez-Maranon,M.;Gamiz,E.;Delgado,G.;Delgado,R."	"Mafic-ultramafic soils affected by silicic colluvium in the Sierra Nevada Mountains (southern Spain)"	1999
"SANCHEZORTEGA,A.;ALBATERCEDOR,J."	"Description and Life-Cycle of Leuctra-Iliberis Sp-N from Southern Spain (Plecoptera, Leuctridae)"	1988
"Sanchez-Vizcaino,VL;Trommsdorff,V.;Gomez-Pugnaire,MT;Garrido,CJ;Muntener,O.;Connolly,JAD"	"Petrology of titanian clinohumite and olivine at the high-pressure breakdown of antigorite serpentinite to chlorite harzburgite (Almirez Massif, S. Spain)"	2005
"Santiago-Moreno,J.;Gomez-Brunet,A.;Gonzalez-Bulnes,A.;Malpaux,B.;Chemineau,P.;Pulido-Pastor,A.;Lopez-Sebastian,A."	"Seasonal ovulatory activity and plasma prolactin concentrations in the Spanish ibex (Capra pyrenaica hispanica) maintained in captivity"	2003
"SANTOS,J.;SENTIS,C.;ROBLEDO,M.;FERNANDEZPIQUERAS,J."	"Nucleolar Dominance in Interracial Hybrids of the Steropleurus-Martorelli Complex"	1990
"Scarciglia,Fabio;Le Pera,Emilia;Critelli,Salvatore"	"The onset of the sedimentary cycle in a mid-latitude upland environment: Weathering, pedogenesis, and geomorphic processes on plutonic rocks (Sila Massif, Calabria)"	2007
"Schmidt,GH;Tanzen,E.;Bellin,S."	"Structure of egg-batches of Thaumetopoea pityocampa (Den. and Schiff.) (Lep., Thaumetopoeidae), egg parasitoids and rate of egg parasitism on the Iberian Peninsula"	1999
"Schulte,L."	"Climatic and human influence on river systems and glacier fluctuations in southeast Spain since the Last Glacial Maximum"	2002
"SEITZ,W."	"Chemosystematology Today - Survey Represented by some Examples of the Angiosperms Families Ranunculaceae, Onagraceae and Valerianaceae as Well as from the Group of Lichens"	1980
"SENTIS,C.;SANTOS,J.;FERNANDEZPIQUERAS,J."	"C-Heterochromatin Polymorphism in Baetica-Ustulata - Intraindividual Variation and Fluorescence Banding-Patterns"	1986
"Seppa,P.;Fernandez-Escudero,I.;Gyllenstrand,N.;Pamilo,P."	"Obligatory female philopatry affects genetic population structure in the ant Proformica longiseta"	2006
"Serrano,Emmanuel;Granados,Jose Enrique;Perez,Jesus M."	"Sarcoptic mange and metapodial development in growing male Iberian ibex (Capra pyrenaica)"	2007
"Serrano-Bernardo,F.;Rosua,J. L.;Diaz-Miguel,M."	"Light and temperature effects on seed germination of four native species of Mediterranean high mountains (Spain)"	2007
"SERVE,L."	"Hitherto Unknown Iberis of Sierra Nevada (South Spain) Iberis-Embergeri Serv, Nov Sp"	1970
"SERVE,L.;BAUDIERE,A."	"Vegetation and Periglacial Dynamics in High Mountainous Environment (Pyrenees-Orientales and Sierra-Nevada) - Recent Development of Vegetation on High Summits of Catalan Pyrenees"	1972
"Shelley,RM"	"The Holarctic centipede subfamily Plutoniuminae (Chilopoda: Scolopendromorpha: Cryptopidae) (Nomen correctum ex subfamily Plutoniinae Bollman, 1893)"	1997
"Simon,M.;Sanchez,S.;Garcia,I."	"Soil-landscape evolution on a Mediterranean high mountain"	2000
"Sinclair,WT;Morman,JD;Ennos,RA"	"The postglacial history of Scots pine (Pinus sylvestris L.) in western Europe: evidence from mitochondrial DNA variation"	1999
"Soler,M.;Martin-Vivaldi,M.;Perez-Contreras,T."	"Identification of the sex responsible for recognition and the method of ejection of parasitic eggs in some potential common cuckoo hosts"	2002
"Sosson,M.;Morillon,AC;Bourgois,J.;Feraud,G.;Poupeau,G.;Saint-Marc,P."	"Late exhumation stages of the Alpujarride Complex (western Betic Cordilleras, Spain): new thermochronological and structural data on Los Reales and Ojen nappes"	1998
"SOUTADE,G.;BAUDIERE,A."	"Vegetation and Forms of High Northern Slopes of Sierra Nevada (Southern Spain)"	1970
"STEINMANN,H."	"The Dermaptera Material in the Museo-Civico Di-Storia-Naturale-Di-Verona (Italy)"	1984
"SURINACH,E.;UDIAS,A."	"Determination of Root Under Sierra-Nevada (Spain) by Numerical Inversion of Seismic Data"	1977
"Sylvester,AG"	"Magma mixing, structure, and re-evaluation of the emplacement mechanism of Vradal pluton, central Telemark, southern Norway"	1998
"TALAVERA,M.;LOPEZLEON,MD;CABRERO,J.;CAMACHO,JPM"	"Male Germ Line Polysomy in the Grasshopper Chorthippus-Binotatus - Extra Chromosomes are Not Transmitted"	1990
"TERCEDOR,JA"	"A New Species of the Genus Oligoneuriella (Ephemeroptera, Oligoneuriidae) from Spain"	1983
"Thornes,JB;Alcantara-Ayala,I."	"Modelling mass failure in a Mediterranean mountain environment: climatic, geological, topographical and erosional controls"	1998
"Tinaut,A.;Fernandez-Escudero,I.;Ruano,F.;Cerda,X."	"The relationship of nest rock dimensions to reproductive success and nest permanence in a high-mountain ant, Proformica longiseta (Hymenoptera : Formicidae)"	1999
"Tirado,R.;Pugnaire,FI"	"Community structure and positive interactions in constraining environments"	2005
"TORRESROLDAN,RL"	"Presence of Calcium Silicates and Seapolite Banded Rocks in Alpujarrid Formations in Sw of Sierra-Nevada (S of Spain) - Geological Significance"	1977
"Torres-Ruiz,J.;Pesquera,A.;Gil-Crespo,PP;Velilla,N."	"Origin and petrogenetic implications of tourmaline-rich rocks in the Sierra Nevada (Betic Cordillera, southeastern Spain)"	2003
"Torres-Ruiz,J.;Pesquera,A.;Sanchez-Vizcaino,VL"	"Chromian tourmaline and associated Cr-bearing minerals from the Nevado-Filabride complex (Betic Cordilleras, SE Spain)"	2003
"TOTH,LG;CRUZPIZARRO,L."	"Respiratory Electron-Transport System (Ets)-Activity of the Plankton and Biofilm in the High-Mountain Lake La Caldera (Sierra-Nevada, Spain)"	1995
"Tovar-Pescador,J.;Pozo-Vazquez,D.;Ruiz-Arias,J. A.;Batlles,J.;Lopez,G.;Bosch,J. L."	"On the use of the digital elevation model to estimate the solar radiation in areas of complex topography"	2006
"Utrillas,MP;Canada,J.;Tamayo,J.;Martinez-Lozano,JA"	"Column integrated aerosol optical properties in the free troposphere: Case study - Sierra Nevada, Spain"	2004
"VAILLANT,F."	"Thaumaleidae from Europe [Diptera]"	1977
"Valero,A.;Hueli,LE;DiazSaez,V."	"Spermatogenesis in the ixodid tick Haemaphysalis (Herpetobia) sulcata (Acarina: Ixodidae)"	1997
"VELILLA,N.;HACHALI,PF"	"The Composition and Zoning of Metabasite Garnets in the Sierra-Nevada (Betic-Cordillera, Se Spain)"	1986
"Villar-Argaiz,M.;Medina-Sanchez,JM;Carrillo,P."	"Microbial plankton response to contrasting climatic conditions: insights from community structure, productivity and fraction stoichiometry"	2002
"Villar-Argaiz,M.;Medina-Sanchez,JM;Cruz-Pizarro,L.;Carrillo,P."	"Inter- and intra-annual variability in the phytoplankton community of a high mountain lake: the influence of external (atmospheric) and internal (recycled) sources of phosphorus"	2001
"Villar-Argaiz,M.;Sanchez,JMM;Cruz-Pizarro,L.;Carrillo,P."	"Life history implications of calanoid Mixodiaptomus laciniatus in C : N : P stoichiometry"	2000
"Viseras,C.;Calvache,ML;Soria,JM;Fernandez,J."	"Differential features of alluvial fans controlled by tectonic or eustatic accommodation space. Examples from the Betic Cordillera, Spain"	2003
"VISERAS,E.;CAMACHO,JPM"	"The B-Chromosome System of Omocestus-Bolivari - Changes in B-Behaviour in M4-Polysomic B-Males"	1985
"Vivero,JL;Hernandez-Bermejo,JE;Ligero,JP"	"Conservation strategies and management guidelines for wild Prunus genetic resources in Andalusia, Spain"	2001
"von Proschwitz,T."	"On the distribution and ecology of Vertigo substriata (Jeffreys), Vertigo modesta arctica (Wallenberg), Vertigo lilljeborgi (Westerlund) and Vertigo alpestris alder in France and on the Iberian Peninsula"	2004
"Werner,O.;Rams,S.;Ros,RM"	"Genetic diversity of Pohlia bolanderi (Mniaceae), a rare and threatened moss in Sierra Nevada (Spain), estimated by ISSR molecular markers"	2005
"Zaldivar,JG;Jabaloy,A.;GonzalezLodeiro,F."	"Reactivation of the Mecina Detachment in the western sector of Sierra Nevada (Betic Cordilleras, SE Spain)"	1996
"ZAMORA,R."	"Avian-Habitat Relationships in a Mediterranean High Mountain"	1991
"ZAMORA,R."	"Observational and Experimental-Study of a Carnivorous Plant - Ant Kleptobiotic Interaction"	1990
"ZAMORA,R."	"Interspecific Aggression by the Wheatear in a High-Mountain Passerine Community"	1990
"ZAMORA,R."	"Nest-Site Selection of the Common Wheatear in High Mountain Areas of Southeastern Spain"	1990
"ZAMORA,R."	"The Feeding Ecology of a Carnivorous Plant (Pinguicula-Nevadense) - Prey Analysis and Capture Constraints"	1990
"ZAMORA,R.;GOMEZ,JM"	"Vertebrate Herbivores as Predators of Insect Herbivores - an Asymmetrical Interaction Mediated by Size Differences"	1993
"Zamora,R.;Gomez,JM;Hodar,JA;Castro,J.;Garcia,D."	"Effect of browsing by ungulates on sapling growth of Scots pine in a Mediterranean environment: consequences for forest regeneration"	2001
"ZAMORAMUNOZ,C.;SANCHEZORTEGA,A.;ALBATERCEDOR,J."	"Physicochemical Factors that Determine the Distribution of Mayflies and Stoneflies in a High-Mountain Stream in Southern Europe (Sierra-Nevada, Southern Spain)"	1993
"ZAMOTAJLOV,AS"	"New Palearctic Species of the Ground Beetles of the Tribe Deltomerini (Coleoptera, Carabidae)"	1990
""	"[Collecting insects, why and for what?]"	1997
"Abolafia,Joaquin;Pena Santiago,Reyes"	"Nematodes of the order Dorylaimida from Andalucia Oriental, Spain. The genus Mesodorylaimus Andrassy, 1959. 2. Two new species with pre- and/or postvulval ornamentations."	1997
"Alasaad,Samer;Granados,Jose E.;Fandos,Paulino;Cano-Manuel,Francisco-Javier;Soriguer,Ramon C.;Perez,Jesus M."	"The use of radio-collars for monitoring wildlife diseases: a case study from Iberian ibex affected by Sarcoptes scabiei in Sierra Nevada, Spain."	2013
"Alba Tercedor,J."	"Baetis maurus Kimmins, 1938 (Ephemeroptera: Baetidae) en la Peninsula Iberica. Aportacion al conocimiento morfologico de la ninfas."	1983
"Alba Tercedor,J."	"Ephemerella (Chitonophora) ikonomovi nevadensis n. ssp. de Sierra Nevada, Espana (Ephemeroptera, Ephemerellidae)."	1983
"Alba Tercedor,J."	"Larvas de plecopteros de las estribaciones de Sierra Nevada (Granada). Factores que intervienen en su distribucion."	1979
"Alba Tercedor,J.;Jimenez Millan,F."	"Larvas de efemeropteros de las estribaciones de Sierra Nevada. Factores que intervienen en su distribucion."	1978
"Alba-Tercedor,J."	"Life cycle and ecology of mayflies from Sierra Nevada (Spain), 4."	1990
"Alba-Tercedor,J."	"Life cycles and ecology of some species of Ephemeroptera from Spain."	1989
"Alba-Tercedor,J."	"Ecologia, distribucion y ciclos de desarrollo de efemeroteros de Sierra Nevada (Granada, Espana). 2. Baetidae (Insecta, Ephemeroptera)."	1984
"Alba-Tercedor,J.;Zamora-Munoz,C.;Sanchez-Ortega,A.;Guisasola,I."	"Mayflies and stoneflies from the Rio Monachil (Sierra Nevada, Spain) (Ephemeroptera and Plecoptera)."	1991
"Anichtchenko,Alexandre"	"A new and little known species of Philorhizus Hope, 1838 (Coleoptera, Carabidae) from Spain."	2005
"Anichtchenko,Alexandre;Verdugo,Antonio"	"Iberodorcadion (Hispanodorcadion) zenete, new Iberian species (Coleoptera, Cerambycidae) of Sierra Nevada (Andalusia, Spain)."	2004
"Arenberger,E."	"Stenoptilia hahni nov. sp. - ein Neufund aus Spanien (Lepidoptera: Pterophoridae)."	1989
"Arroyo Nombela,J. J.;Rodrigues Murcia,C.;Abaigar,T.;Vericad,J. R."	"Cytogenetic analysis (GTG, CBG and NDR bands) of a wild boar population (Sus scrofa scrofa) with chromosomal polymorphism in the south-east of Spain."	1990
"Avila Sanchez-Jofre,J. M.;Pascual Torres,F."	"Contribucion al estudio de los escarabeidos coprofagos de Sierra Nevada (Granada). 6. Autoecologia de las especies. Familia Aphodiidae (Coleoptera, Scarabaeoidea)."	1987
"Avila,J. M.;Pascual,F."	"Los Scarabaeoidea (Col.) coprofagos de los prados humedos de alta montana en Sierra Nevada (Granada, Espana)."	1989
"Avila,J. M.;Pascual,F."	"Contribucion al estudio de los escarabeidos coprofagos de Sierra Nevada. 2. Relaciones con la vertiente, naturaleza del suelo y el grado de dureza, humedad y vegetacion del sustrato (Coleoptera, Scarabaeoidea)."	1986
"Baena,Manuel;Susin,Juana"	"Contribution to knowledge of the Iberian Deraeocorinae (Heteroptera, Miridae, Deraeocorinae)."	1998
"Baldizzone,G."	"Deux nouvelles especes du genre Infurcitinea Spuler (Tineidae)."	1984
"Beaucournu,J. -C"	"Une puce nouvelle de la faune iberique Peromyscopsylla spectabilis viatrix ssp. nova (Siphon. Leptopsyllidae)."	1975
"Beaucournu,J. C.;Gilot,B.;Vericad,J. R."	"Deux Ctenophthalmus nouveaux (Siphonaptera. Hystrichopsylli dae) du sud-est Iberique."	1973
"Bello,C. L.;Alba-Tercedor,J."	"[Effect of the regulation of upper river Genil (Sierra Nevada, Spain) on the aquatic macroinvertebrate community and larval diet of Rhyacophila nevada (Insecta: Trichoptera).]"	2004
"Bengtsson,Bengt A."	"Scythrididae."	1997
"Benoit,F.;Marki,H."	"New data from the winter range of citril finch Serinus citrinella in Spain."	2004
"Betti,G."	"Description d'une nouvelle sous-espi ce de Lysandra hispana H. S. d'Espagne (Lep. Lycaenidae)."	1970
"Bohn,Horst"	"Revision of the carpetana-group of Phyllodromica Fieber from Spain, Portugal and France (Insecta, Blattaria, Blattellidae, Ectobiinae)."	1999
"Bosch i Moner,L."	"Ropalocers interessants recollits a Sierra Nevada i a Santander."	1989
"Braga,J. C.;Martin,J. M."	"Sedimentacion ciclica lagunar y bioconstrucciones asociadas en el Trias superior Alpujarride."	1987
"Cacas,J. J.;Laville,H."	"Micropsectra seguyi, n. sp., du groupe attenuata Reiss (Diptera: Chironomidae) de la Sierra Nevada (Espagne)."	1990
"Calle,J."	"Noctuidae recolectados en Sierra Nevada (Granada). (Contribucion a los Noctuidae espanoles no. 26)."	1980
"Campos,Francisco;Gutierrez-Corchero,Francisco;Lopez-Fidalgo,Jesus;Hernandez,Ma Angeles"	"A new criteria to sex European dippers Cinclus cinclus in the Iberian Peninsula."	2006
"Cano Villegas,Francisco J."	"[Interesting observations of arthropods in the Sierra Nevada (Granada, Andalusia).]"	2008
"Cano-Manuel,Francisco Javier;Granados,Jose Enrique;Aspizua,Rut;Barea,Miguel;Sanchez,Francisco Javier;Henares,Ignacio Luis;Navarro,Francisco Javier"	"Global change and Spanish ibex (Capra pyrenaica) in Sierra Nevada, Spain."	2010
"Caro,Jesus;Fernandez-Cardenete,Juan R.;Moreno-Rueda,Gregorio;Pleguezuelos,Juan M."	"[Status of Coronella austriaca in Sierra Nevada (SE Iberian Peninsula).]"	2012
"Casas,J. J.;Vilchez-Quero,A."	"A faunistic study of the lotic chironomids (Diptera) of the Sierra Nevada (S.E. of Spain): changes in the structure and composition of the populations between spring and summer."	1989
"Castro,Leopoldo;Sanza,Florencio"	"Contribution to the knowledge of the Vespidae (Hymenoptera) of Sierra Nevada (Spain) and some taxonomic notes."	2009
"Cluck,P."	"La Costa del Sol et la Sierra Nevada (Espagne) en ete 1990."	1991
"Cruz-Pizarro,L.;Carrillo,P."	"Top-down regulation under different species-specific and size-structure grazer assemblages in an oligotrophic lake."	1991
"Dahlgren,G."	"Zur Taxonomie der Gattungen Rhagonycha, Pseudocratosilis und Cratosilis (Col. Cantharidae)."	1975
"de Figueroa,Jose Manuel Tierno;Sainz-Cantero,Carmen Elisa"	"First record of Taeniopteryx hubaulti Aubert, 1946 (Plecoptera, Taeniopterygidae) in Southern Iberian Peninsula."	2008
"De Freina,Josef J."	"Notes on biology, distribution and taxonomy of the complex of Heterogynis paradoxa Rambur, 1837, with description of Heterogynis yerayi sp. n. from the Cantabrian Mountains (Lepidoptera: Zygaenoidea, Heterogynidae)."	2011
"de Worms,C. G. M."	"Plebicula golgus Hubner and other butterflies in the Sierra Nevada, July, 1975."	1976
"Defaut,Bernard"	"[Preliminary revision of Chorthippus of the binotatus group (Charpentier, 1825) (Caelifera, Acrididae, Gomphocerinae).]"	2011
"Defaut,Bernard"	"[Validity and fields of application of the diverse taxonomic vocabulary of the Acrididae family (Orthoptera).]"	2008
"d'Hondt,J. -P"	"Liste des lepidopteres rhopaloceres captures ou observes dans la Sierra Nevada (Espagne). (Fin juillet 1983 et pendant le premiere moitie de juillet 1985)."	1985
"Diaz,M.;Soler,M. D.;Benitez,R.;Ruiz,I.;Perez,J. M."	"Presence of supernumerary peripheral setae on the scutum of specimens belonging to subgenus Neotrombicula Hirst, 1915 (Acari: Trombiculidae)."	1988
"Ebmer,A. W."	"Erganzungen zur Bienenfauna Iberiens. Die Gattungen Halictus, Lasioglossum und Dufourea (Apoidea, Hymenoptera)."	1979
"Fandos,Paulino;Arcenegui,Patricia;de los Angeles Lora,Maria;Buron,Daniel;Granados,Jose Enrique;Cadenas,Rafael"	"Demographic trends of Spanish ibex in Andalusia in the last 100 years."	2010
"Fernandez Rubio,F."	"Catalogo de los ropaloceros de Sierra Nevada (Grenada)."	1975
"Fernandez-Rubio,Fidel"	"[Monstrosities and curiosities (4): the aberrant form of Lysandra golgus (Hubner, 1808).]"	1997
"Garrido,J. A.;Irurita,J. M.;Olvera,S.;Tortosa,E.;Valdivieso,O.;Lopez-Sanjuan,R.;Seminario,Y.;Acevedo,J."	"First data from Barbastella barbastellus (Schreber, 1774) (Chiroptera, Vespertilionidae) in Sierra Nevada (Granada, Espana)."	2006
"Gaston,Fco Javier;Redondo,Victor M."	"Idaea davidi sp. n. from Sierra Nevada (Andalucia, Espana) (Lepidoptera: Geometridae, Sterrhinae)."	2005
"Gil,Jose Maria;Molino,Francisco;Valenzuela,Gerardo"	"[Altitudinal distribution of nests of the golden eagle Aquila chrysaetos in Sierra Nevada (southeast Spain).]"	1998
"Gil-T.,Felipe"	"The correct hostplant of Polyommatus golgus (Hubner, 1813): Anthyllis vulneraria pseudoarundana H. Lindb. (Lepidoptera, Lycaenidae)."	2007
"Gomariz Cerezo,G."	"Aportacion al conocimiento de la distribucion y abundancia de Parnassius apollo (Linnaeus, 1758) en Sierra Nevada (Espana meridional) (Lepidoptera: Papilionidae)."	1993
"Gomez,J. M.;Zamora,R.;Tinaut,A."	"Pollination of Ptilotrichum spinosum by ants: experimental study of the quality component."	1990
"Gomez,J. M.;Zamora,R.;Tinaut,A."	"Pollination of Ptilotrichum spinosum by ants: quantity component."	1990
"Gomez-Zurita,Jesus;Petitpierre,Eduard"	"Contribution to the knowledge of the Iberian fauna of Chrysomelidae (Coleoptera). I. New records of Criocerinae, Clytrinae and Cryptocephalinae."	2010
"Gonzalez Moline,A. L.;Tinaut Ranera,J. A.;Gomez Sanchez,R."	"Evolucion estacional de la entomofauna del suelo en un robledal (Quercus pyrenaica Willde) de Sierra Nevada."	1988
"Gonzalez,marcos A.;Malicky,Hans"	"[A new species of Hydropsyche of the pellucidula group (Trichoptera, Hydropsychidae).]"	1999
"Gonzalez-Megias,A.;Gomez,J. M.;Sanchez-Pinero,F."	"Diverse responses of shrub-associated arthropods to ungulate removal."	2005
"Gonzalez-Megias,Adela;Gomez,Jose Maria;Sanchez Pinero,Francisco"	"Ecology of the high mountain chrysomelid Timarcha lugens Rosenhauer (Chrysomelinae)."	2004
"Gunther,A.;Hinz,W."	"Die striate Pisidium-Form (Sphaeriidae, Bivalvia) der Sierra Nevada, Sudspanien."	1989
"Gusenleitner,J."	"Neue Leptochilus-Arten aus dem Mittelmeergebiet und dem Iran (Hymenoptera, Eumenidae)."	1985
"Gusenleitner,J."	"Interessante Faltenwespen aus dem Hochgebirge Spaniens (Hymenoptera, Vespoidea)."	1983
"Hacker,Hermann"	"[The revision of the genus Hadena Schrank, 1802 (Lepidoptera: Noctuidae).]"	1996
"Harz,K."	"Die Orthopteren Europas 2."	1975
"Holzel,H."	"Ein neuer trichterbauender Ameisenli we aus Sudwesteuropa (Planipenna)."	1974
"Huemer,Peter"	"Beitrag zur Kenntnis alpiner Dichrorampha-Arten der Iberischen Halbinsel (Lepidoptera: Tortricidae)."	1993
"Ibanez,Salvador;Gil-T.,Felipe"	"Contribution to the knowledge of Agrodiaetus violetae Gomez-Bustillo, Exposito & Martinez, 1979 sensu lato, an endemic Iberian species; new localities and first records for Sierra Nevada and Almeria Province (S. Spain). (Lepidoptera, Lycaenidae)."	2012
"Ibanez,Salvador;Gil-T.,Felipe"	"First records of the endemic Polyommatus golgus (Huebner, 1913) and Agriades zullichi (Hemming, 1933) in Almeria province (E. Sierra Nevada, S. Spain) (Lepidoptera, Lycaenidae)."	2009
"Jeanne,C."	"Carabiques nouveaux (5."	1974
"Jeekel,C. A. W."	"Notes on some Chilopoda from the Sierra Nevada, Spain."	2003
"Jesus Lopez-Rodriguez,Manuel;Miguel Luzon-Ortega,Julio;Manuel Tierno de Figueroa,Jose"	"On the biology of two high mountain populations of stoneflies (Plecoptera, Perlodidae) in the southern Iberian Peninsula."	2012
"Jimenez Guirado,D.;Calatayud,L.;Pena Santiago,R."	"[Morphometrical analysis of the genus Anatonchus Cobb, 1916 (Nematoda, Mononchida) in Spain.]"	1996
"Jose Bullejos,Francisco;Carrillo,Presentacion;Gorokhova,Elena;Manuel Medina-Sanchez,Juan;Villar-Argaiz,Manuel"	"Nucleic Acid Content in Crustacean Zooplankton: Bridging Metabolic and Stoichiometric Predictions."	2014
"Jose Guerrero,Juan;Ortiz,Antonio S.;Maria Rubio,Rosa"	"On the distribution of Idaea gelbrechti Hausmann, 2003 in the Ibero-Maghrebian region (Geometridae: Sterrhinae)."	2012
"Lacourt,J."	"Note sur quelques hymenopteres tenthredoides captures dans la Sierra-Nevada (Espagne), avec description d'une nouvelle espece du genre Tenthredo L."	1973
"Leclercq,J."	"En vue d'une monographie du genre Lindenius Lepeletier & Brulle (Hymenoptera Sphecidae Crabroninae)."	1989
"Liebanas,Gracia;Pena Santiago,Reyes"	"Nematodes of the order Dorylaimida from Andalucia Oriental, Spain. The genus Nygolaimus Cobb, 1913. 2. Description of two new species."	1997
"Lopez-Colon,J. I."	"Nuevos datos sobre Lucanidae y Melolonthidae de Sierra Nevada (Sur de la Peninsula Iberica) (Col.)."	1992
"Lopez-Rodriguez,M. J.;Luzon-Ortega,J. M.;de Figueroa,J. M. Tierno"	"Contribution to the knowledge of the stoneflies (Insecta, Plecoptera) of the \"Parque Natural de las Sierras de Almijara, Tejeda y Alhama\" and surrounding areas (southeastern Spain), with special reference to its faunistic singularities."	2003
"Lucolli,Silvana"	"[Sierra Nevada and the monitoring of birds of prey through the 'Projeto Glochamore' (Global Change in Mountain Regions).]"	2008
"Madero Montero,A.;Tinaut Ranera,A."	"Fenologia de los vespidos (Hym. Vespidae) en Sierra Nevada (Granada, Espana)."	1987
"Madero,A.;Tinaut,A."	"Distribucion altitudinal de lo vespidos en Sierra Nevada (Granada, Espana) Hymenoptera, Vespidae)."	1985
"Manuel Tierno De Figueroa,J.;Luzon-Ortega,Julio M.;Lopez-Rodriguez,Manuel J."	"First record of male drumming call of the genus Capnioneura Ris, 1905 (Plecoptera, Capniidae)."	2009
"Marki,Hans;Bibier,Olivier;Perez-Contreras,Juan"	"The Citril Finch Serinus citrinella, a regular breeding bird in the Sierra Nevada (Andalusia, Spain)."	2012
"Martinez Rica,J. P."	"Diversity of alpine vertebrates in the Pyrenees and Sierra Nevada, Spain."	2003
"Martinez,R."	"Seasonal variation of phytoplankton biomass and photosynthesis in the high-mountain Lake La Caldera (Sierra, Nevada, Spain)."	1980
"Martinez,T."	"Regimen alimentario de la cabra montes (Capra pyrenaica) en la zona alpina de Sierra Nevada durante los meses de Julio y Agosto."	1990
"Martin-Vivaldi,M.;Marin,J. M.;Villar,M."	"Seleccion de habitat, tamano de bando y movimientos locales del acentor alpino (Prunella collaris) en Sierra Nevada (SE de Espana)."	1995
"Monasterio Leon,Yeray;Escobes Jimenez,Ruth"	"New records of Artimelia latreillei (Lepidoptera: Arctiidae, Arctiinae) from Andalusia (Spain)."	2009
"Morales Baquero,R."	"Distribucion de los rotiferos de la zona litoral de las lagunas de alta montana de Sierra Nevada, Espana."	1987
"Morales-Baquero,R.;Carrillo,P.;Cruz-Pizarro,L.;Sanchez-Castillo,P."	"Southernmost high mountain lakes in Europe (Sierra Nevada) as reference sites for pollution and climate change monitoring."	1992
"Moreno-Rueda,G."	"Nest-box selection by insectivorous birds in Sierra Nevada."	2003
"Mueller,B."	"Idaea gelbrechti Hausmann, 2003 new for Spain and Europe (Lepidoptera: Geometridae)."	2010
"Munguira,M. L.;Martin,J."	"The Sierra Nevada blue, Polyommatus golgus (Hubner)."	1993
"Ocana,A.;Hernandez,J. A.;Monterrubio,E."	"Description of Achromadora gracilis n. sp. and observations on A. micoletzkyi (Stefanski, 1915) Van der Linde, 1938 and Ethmolaimus multipapillatus Paramonov, 1926 (Nematoda: Chromadorida) from Spanish lakes."	1999
"Ortiz-Sanchez,F. J."	"A relict population of Anthophora (Clisodon) furcata (Panzer, 1798) in Sierra Nevada, first record from the southern half of the Iberian Peninsula (Hymenoptera, Anthophoridae)."	2007
"Padial,Jose M.;Romero-Pujante,Marilo;Hernandez,Francisco J.;Donazar,Jose A.;Godino,Alfonso;Carrasco,Antonio;Couto,Sergio;Gutierrez,Jose E.;Ruiz,Antonio;Garcia-Baquero,Maria J.;Simon,Miguel A."	"Habitat assessment for the reintroduction of the bearded vulture Gypaetus barbatus in Andalusia (south Spain)."	2006
"Palomares,F."	"Notas sobre la intraduccion y expansion de la ardilla comun en Sierra Nevada, sureste de Espana."	1988
"Palomares,Francisco;Clemencia Amaya,Gloria"	"First record of Cervus elaphus at eastern Sierra Nevada."	2014
"Pardo Alcaide,A."	"Estudios sobre Meloidae (Coleoptera). 24. Una neuva especie de Mylabris Fabricius (Mylabris platai n. sp.) de Sierra Nevada."	1975
"Pascual,F."	"Estudio preliminar de los ortopteros de Sierra Nevada. 1. Introduccion general e inventario de especies."	1978
"Pascual,F."	"Descripcion de una neuva especie de Omocestus Bolivar, 1878, de Sierra Nevada, Espana (Orth., Acrididae, Gomphocerinae)."	1978
"Pascual,F."	"Descripcion de una nueva especie de Chorthippus Fieber, 1852, de Sierra Nevada, Espana (Orth., Acrididae)."	1978
"Pascual,F."	"Estudio preliminar de los ortopteros de Sierra Nevada. 2: Claves para la determinacion de especies."	1978
"Pascual,F."	"Estudio preliminar de los ortopteros de Sierra Nevada, 3: Distribucion ecologica."	1978
"Passerin d'Entreves,P."	"Two new species of Scythris (Lepidoptera: Scythrididae) from Spain."	1990
"Pena Santiago,Reyes;Abolafia,Joaquin"	"Nematodes of the order Dorylaimida from Andalucia Oriental, Spain. The genus Mesodorylaimus Andrassy, 1959. V. Two new species close to M. bastiani with a compendium of its relatives."	2000
"Perez Lopez,F. J."	"Panchrysia deaurata (Esper, 1787) en la provincia de Granada (Lepidoptera: Noctuidae)."	1989
"Perez Lopez,Francisco Javier;Yela,Jose Luis"	"El genero Chersotis Boisduval, 1840 (Lepidoptera, Noctuidae) en Sierra Nevada (Granada, sur de Espana): datos faunisticos, taxonomicos, biogeograficos y de distribucion altitudinal."	1994
"Perez Martinez,Carmen;Barea Arco,Jose"	"[Relation between host size and infection intensity of an algal epibiont.]"	2000
"Perez,Jesus M.;Ruiz-Martinez,Isidoro;Granados,Jose E.;Soriguer,Ramon C.;Fandos,Paulino"	"The dynamics of sarcoptic mange in the ibex population of Sierra Nevada in Spain - influence of climactic factors."	1997
"Perez-Aranda,Diana;Carro,Francisco;Garrido,Jose Antonio;Cano,Javier;Castillo,Antonio;Grandados,Jose Enrique;Suarez,Francisco;Soriguer,Ramon C."	"Recent findings on snow vole Chionomys nivalis (Martins 1842) distribution in the Sierra Nevada (Andalucia, Spain)."	2007
"Perez-Aranda,Diana;Suarez,Francisco;Soriguer,Ramon C."	"Space use patterns of the snow vole Chionomys nivalis (Martins, 1842)."	2009
"Perez-Chiscano,J. L.;de Lope Rebollo,F."	"Observaciones ornitologicas en la zona alta de Sierra Nevada."	1984
"Perez-Contreras,J.;Garzon Gutierrez,J.;Garcia,I.;Tamayo,A."	"Status of the citril finch Serinus citrinella (Pallas, 1764) in Sierra Nevada (Spain)."	2005
"Petitpierre,E.;Daccordi,M."	"Chrysomelidae (Coleoptera) from the mountains of the High Plateau of Granada (Granada, Andalusia)."	2013
"Pont,Adrian C.;Gregor,Frantisek"	"A new species of the genus Coenosia Meigen, 1826 (Diptera: Muscidae) from the Sierra Nevada, Spain."	2008
"Puetz,A."	"[Second contribution to the knowledge of the genus Trichobyrrhulus Ganglbauer, 1902 (Coleoptera: Byrrhidae).]"	2004
"Pulawski,W."	"Les Tachysphex Kohl (Hym., Sphecidae) de la region palearctique occidentale et centrale."	1973
"Ramon Fernandez-Cardenete,Juan;Tierno de Figueroa,Jose Manuel"	"First records of Osmylus fulvicephalus (Scopoli. 1763) in southern Iberian Peninsula (Planipennia, Osmylidae)."	2002
"Rasmont,P."	"Catalogue commente des bourdons de la region ouest-palearctique (Hymenoptera, Apoidea, Apidae)."	1983
"Rieradevall,M.;Prat,N."	"[The zoobenthos of lakes and aquatic areas of the high mountains of the Iberian Peninsula and their value as indicators of environmental changes.]"	2000
"Rowlings,Matthew"	"An early morning in the Sierra Nevada, Spain."	2000
"Ruano,F.;Tinaut,A."	"The history of entomology in the Sierra Nevada mountains (southern Spain) from 1813 to 2000 (1)."	2003
"Ruano,Francisca;Tinaut,Alberto;Sanllorente,Olivia;Fernandez-Zambrano,Alejandra"	"New localities for Rossomyrmex minuchae Tinaut, 1981 (Hymenoptera, Formicidae)."	2007
"Ruiz Bustos,A."	"Numerical coding of the molar morphology of the family Muridae Gray, 1821, (Rodentia) for its lineage knowledge, and implications in: biostratigraphy, paleoecology and composition of a correlation language from the phenotype to the genotype."	2004
"Ruiz Bustos,A.;Camacho Munoz,I."	"Datos sobre la alimentaciOn del Bubo bubo y determinacion de micromamiferos en Sierra Nevada mediante egagropilas."	1973
"Ruiz Bustos,A.;Padial,J."	"Datos sobre Microtus nivalis (Martens, 1842) actual y fosil en Granada (Andalucia)."	1980
"Sainz Cantero,C. E.;Sanchez Ortega,A.;Alba Tercedor,J."	"Distribucion y autoecologia de Hydraenidae (Col.) en Sierra Nevada (Espana)."	1987
"Sainz-Barain,Marta;Zamora-Munoz,Carmen"	"The larva and life history of Stenophylax nycterobius (McLachlan, 1875) (Trichoptera: Limnephilidae) in high mountain streams (Sierra Nevada, Spain) and key to the Iberian larvae of the genus."	2012
"Sainz-Cantero,C. E.;Alba-Tercedor,J."	"Los adefagos acuaticos de Sierra Nevada (Granada, Espana): diagnosis y claves de identificacion (Coleoptera, Adephaga: Haliplidae, Gyrinidae, Dytiscidae)."	1991
"Sainz-Cantero,C. E.;Sanchez-Ortega,A.;Alba-Tercedor,J."	"Datos de distribucion y autoecologia de los coleopteros Dryopoidea en Sierra Nevada (Espana)."	1985
"Sainz-Cantero,Carmen E.;Alba-Tercedor,Javier;Fresneda,Xavier"	"Sobre la distribucion de Agabus (Gaurodytes) solieri Aube, 1836 en la Peninsula Iberica (Coleoptera: Dytiscidae)."	1994
"Sanchez-Ortega,A.;Alba-Tercedor,J."	"The life cycle of Perla marginata and Dinocras cephalotes in Sierra Nevada (Granada, Spain) (Plecoptera: Perlidae)."	1991
"Sanchez-Ortega,A.;Alba-Tercedor,J."	"Los plecopteros de Sierra Nevada (Granada, Espana)."	1990
"Sanchez-Ortega,A.;Alba-Tercedor,J."	"Life cycles of some species of Plecoptera in Sierra Nevada (south of Spain)."	1989
"Schmidt,Gerhard H."	"[A contribution to the altitudinal distribution of Orthopteroidea in the Sierra Nevada/Spain.]"	1999
"Schmidt-Koehl,W."	"Tagfalterbeobachtungen in Marokko (Mittlererer Atlas, Hoher Atlas) und in Suedspanien (Sierra Nevada) im Juli und August 1977 (Insecta, Lepidoptera)."	1978
"Serra-Tosio,B."	"Deux Diamesini nouveaux d'Espagne (Diptera, Chironomidae)."	1970
"Shaverdo,H. V."	"Revision of the nigrita-group of Hydroporus Clairville, 1806 (Insecta: Coleoptera: Dytiscidae)."	2004
"Soldan,T."	"[The Spanish Sierra Nevada and its natural history.]"	1987
"Stary,J.;Mendl,H."	"Zwei neue Protogonomyia-Arten aus Europa (Diptera, Limoniidae)."	1984
"Stueben,Peter E."	"[Description of a new Kyklioacalles species from south Spain - with a key to the species of the genus Kyklioacalles. (Col.: Curculionidae, Cryptorhynchinae).]"	2001
"Talavera,M."	"Some species of the family Tylenchidae (Nematoda: Tylenchida) from Sierra Nevada (S.E. Spain)."	1997
"Talavera,M.;Tobar,A."	"Description of Pratylenchoides nevadensis sp. n. from southern Spain (Tylenchida: Pratylenchidae)."	1996
"Tierno de Figueroa,J. M.;Luzon-Ortega,J. M.;Sanchez-Ortega,A."	"Phenology of stoneflies (Insecta, Plecoptera) from Sierra Nevada (Granada, Spain)."	2001
"Tierno de Figueroa,J. M.;Sanchez-Ortega,A."	"Eggs and clutches of some stonefly species (Insecta, Plecoptera) in Sierra Nevada (Granada, Spain)."	1999
"Tierno de Figueroa,Jose Manuel;Lopez-Rodriguez,Manuel Jesus"	"Biometric relationships among female size, fecundity, and flight period in Isoperla nevada Aubert 1952 (Plecoptera: Perlodidae)."	2005
"Tierno de Figueroa,Jose Manuel;Sanchez-Ortega,Antonino"	"Imaginal feeding of twelve nemouroidean stonefly species (Insecta, Plecoptera)."	2000
"Tinaut Ranera,J. A."	"Rossomyrmex minuchae nov. sp. (Hym. Formicidae) encontrada en Sierra Nevada, Espana."	1981
"Tinaut Ranera,J. A."	"Estudio de la mirmecofauna de los Borreguiles de S. Juan (Sierra Nevada, Granada) (Hym. Formicidae)."	1979
"Tinaut,A.;Martinez-Ibanez,M. D.;Ruano,F."	"Inventory of the ant species of Sierra Nevada, Granada (Spain) (Hymenoptera, Formicidae)."	2007
"Tinaut,Alberto"	"First record of the genus Amblyopone Erichson, 1842 (Hymenoptera, Formicidae) in Sierra Nevada (Granada) and Oriental Andalusia."	2007
"Traugott-Olsen,E."	"Variation in Elachista biatomella (Stainton, 1848). A review of the species-group, with description of four new species (Lepidoptera: Elachistidae)."	2000
"Traugott-Olsen,E."	"Description of a new species of Commophila Hubner, (1825) from Sierra Nevada (Spain) (Lepidoptera: Cochylidae)."	1990
"Traugott-Olsen,E."	"Five new Elachista species from Sierra Nevada."	1985
"Traugott-Olsen,E."	"Three new Elachista-species & supplement to the description of the five n. sp. from Sierra Nevada: Shilap Revta. Lepid. Vol. 13 no. 49 (1985): 73-79."	1985
"Traugott-Olsen,E."	"Una neuva cita de Earias vernana (Huebner 1799) para la peninsula iberica."	1985
"Travesi Ydanez,Roberto"	"Mariposas de Sierra Nevada."	1994
"Travesi Ydanez,Roberto"	"Un reciente brote de sarna afecta a la cabra montes de Sierra Nevada."	1993
"Triberti,P."	"Notes on Parornix szoecsi Gozmany (Gracillariidae) and allied species, with description of P. incerta, n. sp."	1982
"Vaillant,F."	"Psychodidae - Psychodinae [continuing]."	1976
"Valdes Cano,J."	"The zooplancton dormancy as a tool to study the recent environmental changes: the lakes from Sierra Nevada (Granada, Spain)."	2006
"Valverde,J.;Calatayud,J.;Gomez,J. M.;Perfectti,F."	"Intra-seasonal variation of Erysimum mediohispanicum flower visitors in Sierra Nevada (Spain)."	2014
"Vilchez Quero,A.;Casas Jimenez,J."	"Quironomidos (Diptera) de los rios de Sierra Nevada (Granada, Espana)."	1987
"Wagner,R."	"Neue Wiedemannia-Arten aus der rhynchops-Gruppe (Diptera, Empididae, Clinocerinae)."	1990
"Wagner,R."	"Zwei neue Psychodiden (Diptera: Psychodidae) aus Sudeuropa."	1979
"Wagner,Wolfgang"	"Observations on foodplants of caterpillars of Pyrgus onopordi (Rambur 1839) in Andalusien (Lepidoptera: Hesperiidae)."	2009
"Wyrwoll,Thomas W."	"A revised description of the Mediterranean (= southern Spanish) ibex."	1999
"Zamora Rodriguez,R."	"Variaciones altitudinales en la composicion de las comunidades nidificantes de aves de Sierra Nevada (Sur de Espana)."	1987
"Zamora,R."	"The selection of song perches among high-mountain passerines of southeastern Spain."	1991
"Zamora,R."	"Importancia de los neveros como sustrato de alimentacion para los Passeriformes de alta montana."	1990
"Zamora,R."	"Estructura morfologica de una comunidad de Passeriformes de alta montana (Sierra Nevada, SE de Espana)."	1988
"Zamora,R."	"Composicion y estructura de las comunidades de Paseriformes de alta montana de Sierra Nevada (se de Espana)."	1988
"Zamora,R.;Camacho,I."	"Evolucion estacional de la comunidad de aves en un encinar de Sierra Nevada."	1984
"Zamora,R.;Camacho,I."	"Evolucion estacional de la comunidad de aves en un robledal de Sierra Nevada."	1984
"Zamora,R.;Tinaut,A."	"A morphological comparison between prey and kleptoparasitic ants (Formica fusca group) of a carnivorous plant (Pinguicola nevadense, (Linb) Casper, 1962). (Hymenoptera; Lentibulariacea)."	1990
"Zamora,Regino"	"Seasonal variation of a passerine community in a Mediterranean high-mountain."	1990
